Wo, Wo, Wo, Wo, Wo, Wo, Wo, Wo, Wo, Wo, Wo, Wo, Wo, Wo, Wo, Wo, Wo, Wo, Wo, Wo, Wo, Wo, Wo, Wo, Wo, Wo, Wo, Wo, Wo, Wo, Wo, Wo, Wo, Wo, Wo, Wo, Wo, Wo, Wo, Wo, Wo, Wo, Wo, Wo, Wo, Wo, Wo, Wo, Wo, Wo, Wo, Ds, Ds, Ds, Ds, Ds, Wog, Wog, Wog, Wog, Wog, Wog, Wog
Wo, Wo, Wo, Wo, Wo, Wo, Wo, Wo, Wo, Wo, Wo, Wo, Wo, Wo, Wo, Wo, Wo, Wo, Wo, Wo, Wo, Wo, Wo, Wo, Wo, Wo, Wo, Wo, Wo, Wo, Wo, Wo, Wo, Wo, Wo, Wo, Wo, Wo, Wo, Wo, Wo, Wo, Wo, Wo, Wo, Wo, Wo, Wo, Wo, Wo, Wo, Wo, Wo, Wog, Wog, Wog, Wog, Wog, Wog, Wog, Wog, Wog, Wog
Wo, Wo, Wo, Wo, Wo, Wo, Wo, Wo, Wo, Wo, Wo, Wo, Wo, Wo, Wo, Wo, Wo, Wo, Wo, Wo, Wo, Wo, Wo, Wo, Wo, Wo, Wo, Wo, Wo, Ds, Gd^Fmw, Ds, Wo, Wo, Wo, Wo, Wo, Wo, Wo, Wo, Wo, Wo, Wo, Wo, Wo, Wo, Wo, Wo, Wo, Wo, Wo, Wo, Wo, Wo, Wo, Wog, Wo, Wog, Wog, Wog, Wog, Wog, Wog
Wo, Wo, Wo, Wo, Ds, Wo, Wo, Wo, Wo, Wo, Wo, Wo, Wo, Wo, Wo, Wo, Wo, Wo, Wo, Wo, Wo, Chw, 7 Khw, Chw, Wo, Wo, Wo, Wo, Ds, Gd^Fmw, Wo, Wo, Wo, Wo, Wo, Wo, Wo, Wo, Wo, Wo, Wo, Wo, Wo, Wo, Wo, Wo, Wo, Wo, Wo, Wo, Wo, Wo, Wo, Wo, Wo, Wo, Wo, Wo, Wo, Wog, Wog, Wog, Wog
Wo, Wo, Wo, Wo, Ds, Ds, Mm, Ds, Ds, Wo, Wo, Wo, Wo, Wo, Wo, Wo, Wo, Wo, Wo, Wo, Wo, Wo, Chw, Wo, Wo, Wo, Wo, Wo, Wo, Ds, Wo, Wo, Wo, Wo, Wo, Wo, Wo, Wo, Wo, Wo, Wo, Wo, Wo, Wo, Wo, Wo, Wo, Wo, Wo, Wo, Wo, Wo, Wo, Wo, Wo, Wo, Wo, Wo, Wo, Wo, Wog, Wog, Ds
Wo, Wo, Wo, Wo, Wo, Gd^Fmw, Ds, Gd, Wo, Wo, Wo, Wo, Wo, Wo, Wo, Wo, Wo, Wo, Wo, Wo, Wo, Wo, Wo, Wo, Wo, Wo, Wo, Wo, Wo, Wo, Wo, Wo, Wo, Wo, Wo, Wo, Wo, Wo, Wo, Wo, Wo, Wo, Wo, Wo, Wo, Wo, Wo, Wo, Wo, Wo, Wo, Wo, Wo, Wo, Wo, Wo, Wo, Wo, Wo, Wo, Wo, Ds, Ds
Wo, Wo, Wo, Wo, Wo, Ds, Wo, Wo, Wo, Wo, Wo, Wo, Wo, Wo, Wo, Wo, Wo, Wo, Wo, Wo, Wo, Wo, Wo, Wo, Wo, Wo, Wo, Wo, Wo, Wo, Wo, Wo, Wo, Wo, Wo, Wo, Wo, Wo, Wo, Wo, Wo, Wo, Wo, Wo, Wo, Wo, Wo, Wo, Wo, Wo, Wo, Wo, Wo, Wo, Wo, Wo, Wo, Wo, Wo, 1 Wo, Wo, Wo, Ds
Wo, Wo, Wo, Wo, Wo, Wo, Wo, Wo, Wwr, Wo, Wwr, Wo, Wo, Wo, Wo, Wo, Wo, Wo, Wo, Wo, Wo, Wo, Wo, Wo, Wo, Wo, Wo, Wo, Wo, Wo, Wo, Wo, Wo, Wo, Wo, Wo, Wo, Wo, Wo, Wo, Wo, Wo, Wo, Wo, Wo, Wo, Wo, Wo, Wo, Wo, Wo, Wo, Wo, Wo, Wo, Wo, Wo, Wo, Wo, Wo, Wo, Ds, Ds
Wo, Wo, Wo, Wo, Wo, Wo, Ww, Wo, Ww, Wwr, Wwr, Wwr, Wwr, Wo, Wo, Wo, Wo, Wo, Wo, Wo, Wo, Wo, Wo, Wo, Wo, Wo, Wo, Wo, Wo, Wo, Wo, Wo, Wo, Wo, Wo, Wo, Wo, Wo, Wo, Wo, Wo, Wo, Wo, Wo, Wo, Wo, Wo, Wo, Wo, Wo, Wo, Wo, Wo, Wo, Wo, Wo, Wo, Wo, Wo, Wo, Wo, Ds, Wo
Ww, Ww, Ww, Ww, Ww, Ww, Ww, Ww, Ww, Ww, Ww, Wwr, Ww, Wo, Wo, Wo, Wo, Wo, Wo, Wo, Wo, Wo, Wo, Wo, Wwr, Wwr, Wwr, Wo, Ww, Ww, Ww, Ww, Ww, Wo, Ww, Ww, Ww, Ww, Ww, Ww, Wwr, Wo, Wo, Wo, Wo, Wo, Wo, Wo, Wwr, Wwr, Wwr, Wo, Ww, Ww, Ww, Ww, Ww, Ww, Ww, Ww, Ww, Ww, Ww
Ds, Ds, Ds, Ds, Ds, Ww, Ds, Ww, Ds, Ww, Ww, Ww, Ww, Ww, Ww, Ww, Ww, Ww, Ww, Wo, Ww, Wo, Ww, Wo, Ww, Ww, Ww, Ww, Ww, Ww, Ww, Ww, Ww, Ww, Ww, Ww, Ww, Ww, Ww, Ww, Ww, Wwr, Wwr, Wwr, Wo, Wo, Ww, Ww, Ww, Wwr, Ww, Wwr, Wwr, Wwr, Ww, Ww, Ww, Ww, Ds, Ds, Ds, Ds, Ds
Gd, Gd, Gd, Gd, Gd, Ds, Gg, Ds, Ds, Ds, Ds, Ww, Ds, Ww, Ds, Ww, Ww, Ww, Ww, Ww, Wwr, Ww, Ww, Ww, Ww, Ww, Ww, Ww, Ww, Ww, Ww^Bw|, Ww, Ww^Bw|, Ww, Ww^Bw|, Ww, Ww, Ww, Ww, Ww, Ww, Ww, Ww, Wwr, Ww, Ww, Ww, Ww, Ww, Ww, Ds, Ww, Ds, Ds, Ds, Ds, Ds, Ds, Gs, Gd, Gd, Gd, Gg
Gs, Gd, Gd, Gs, Gg, Gg, Gg, Gg, Ch, Ch, Ch, Ds, Ds, Ds, Ds, Ds, Ds, Ww, Wwr, Wwr, Ds, Wwr, Ds, Ww, Ds, Ww, Ds, Ww, Ds, Ds, Rp^Bw|, Ww, Rp^Bw|, Rp^Ebn, Rp^Bw|, Ww, Ww, Ds, Ds, Ds, Ds, Ds, Ds, Ww, Ds, Ww, Ds, Ds, Ds, Ds, Ds, Ds, Gd, Ds, Gd, Ds, Gs, Gs, Gg, Gs, Gg, Gg, Gg
Gg, Gs, Gs, Gs, Gg, Xof, Gg, Gg, Ch, 5 Kh, Ch, Gg, Gg, Gg, Gs^Fds, Ds, Gg, Ds, Ds, Ds, Ds, Ds, Gg, Ds, Gg, Ds, Gg, Ds, Ch, Rp, Rp, Rp, Rp, Rp, Rp, Ww, Ww, Ch, Gs, Ds, Ds, Ds, Ds, Ds, Ds, Ds, Gs, Gs, Gg, Gs, Gs, Gd, Gs, Gd, Gs, Gs, Gg, Gg, Gg, Gg, Gg, Gg, Gg
Gg, Gg, Gg, Gg, Xof, Xof, Rr, Rr^Vhc, Rr, Ch, Gg, Gg, Hh^Vhh, Gs^Fds, Gs^Fds, Gs^Fds, Gg, Ds, Gd, Ds, Gg, Gg, Gg, Gg, Gg, Gg, Gg, Gg, Gg, Gg, Gg, Rr^Vhc, Rr, Rp, Gg, Ww, Ww, Gg, Gs, Ds, Ds^Fdw, Ds^Fdw, Gs, Gs, Gg, Gs, Xof, Gg, Gg, Gg, Gg, Gs, Gg, Gg, Ch, Gg, Gg, Gg, Rr, Gg, Rr, Gg, Rr
Gg, Gg, Gg^Ebn, Xof, Rr, Rr, Rr^Vhc, Rr, Rr, Rr^Vhc, Gg, Gg, Gs^Fds, Gs^Fds, Gs^Fds, Gg, Gg, Gg, Gg, Gg, Gg, Gs^Fds, Gs^Fds, Gs^Fds, Gs^Fds, Gg, Gg, Gg, Wwf, Xof, Gg, Gg, Rr, Gg, Gg, Rr^Vhc, Ww, Gg, Gg, Gd^Fdw, Gd^Fmw, Gd^Fdw, Gg, Gg, Xof, Xof, Xof, Xof, Xof, Gg, Hh, Hh, Gg, 2 Kh, Ch, Gg, Rr, Rr, Gg, Rr, Gg, Rr, Gg
Rr, Gg, Rr, Rr, Gg^Efm, Gg^Efm, Gg^Efm, Gg^Efm, Xof, Rr, Rr, Gg, Gg, Gg, Gg^Ebn, Gg, Gg, Gg, Gg, Gg, Gg, Ss, Ss, Gs^Fds, Gs^Fms, Gs^Fds, Gg^Fms, Ww, Ww, Xof, Gg, Hh, Rr, Gg, Ww, Ww, Gg^Ebn, Gg, Gg, Gg, Gg, Gg, Xof, Xof, Gg, Wwf, Wwf, Wwf, Hh, Xof, Xof, Hh, Rr, Rr^Vhc, Rr, Rr, Rr^Vhc, Gg, Gs, Gg, Gg, Gg, Hh
Gg^Efm, Rr, Gg^Efm, Gg^Efm, Gg^Efm, Gg^Efm, Gg, Gg, Gg, Xof, Xof, Rr, Rr, Rr, Rr, Rr, Rr, Rr^Vhc, Ss, Ss^Bw\, Rr^Vhc, Gg, Gg, Gg, Gg^Fms, Gg^Fms, Gg, Ww, Wo, Xof, Gs^Fds, Hh, Rr, Gg, Gg, Ww, Ww^Bsb/, Rr, Rr, Rr, Rr, Rr, Rr, Rr^Vhc, Rr, Rr, Rr, Rr, Rr, Rr, Rr, Rr, Xof, Rr, Gg, Gg, Gg, Gg, Gs, Gs, Gg^Fds, Hh^Fds, Hh
Gg^Efm, Gg^Efm, Gg^Efm, Gg^Efm, Gg, Gg, Gg, Gg, Gs^Fds, Gg, Gs^Fds, Gg, Gg, Rr, Gg^Eff, Gg, Gg, Rr, Rr, Rr, Rr, Rr, Rr, Gg, Gg, Gg, Gg, Ww, Xof, Xof, Gg, Gg, Rr, Rr^Vhc, Rr, Rr, Xof, Ww, Ww, Gg, Gg, Gg, Rr^Vhc, Rr, Gg, Gg, Gs^Fds, Gg, Gg, Rr^Vhc, Rr, Xof, Ww, Rr^Vhc, Gg, Gg, Gs, Gs, Gg, Gg^Fds, Hh^Fds, Hh^Fds, Mm
Gg^Efm, Gg^Efm, Gg^Efm, Gg^Efm, Gg, Gg, Gg, Gs^Fds, Gs^Fds, Gs^Fds, Gs^Fds, Gs^Fds, Gg, Gg, Gg, Gg^Eff, Gg^Eff, Rr^Vhc, Gg, Gg^Efm, Gg^Efm, Gg^Efm, Gg^Efm, Rr, Rr, Gg, Xof, Xof, Gg, Gg, Ch, Gg, Rr, Rr, Rr^Vhc, Xof, Xof, Ww, Ww, Gg^Ebn, Rr, Rr, Rr, Rr, Gg, Gs^Fds, Hh^Ve, Gs^Fds, Gs^Fds, Rr, Xof, Xof, Wwf, Gg, Gg, Gs, Gg, Gg, Gg, Gg^Fds, Gg^Vhh, Mm, Mm
Gg^Efm, Gg^Efm, Gg^Efm, Gg^Efm, Gg, Gg, Gs^Vh, Gs^Fds, Rb^Gvs, Gs^Fds, Rb^Gvs, Gs^Fds, Gs^Fds, Gg, Gs^Vh, Gg, Rb^Gvs, Gg^Eff, Gg^Eff, Gg^Efm, Gg^Efm, Gg^Efm, Gg^Efm, Gg^Efm, Gg^Efm, Rr, Rr, Gg, Ch, Ch, 4 Kh, Rr, Gg, Rr, Rr, Rr, Ww^Bsb\, Ww, Rr, Rr, Xof, Xof, Xof, Rr, Gg, Gs^Fds, Hh^Fds, Hh^Fds, Gs^Fds, Rr, Xof, Wwf, Gg, Gg, Gg^Fds, Gg, Gg^Fds, Gg, Gg^Fds, Hh^Fds, Mm, Mm, Mm
Gg^Efm, Gg^Efm, Gg, Gg, Rb^Gvs, Rb^Gvs, Rb^Gvs, Rb^Gvs, Rb^Gvs, Rb^Gvs, Rb^Gvs, Rb^Gvs, Rb^Gvs, Gg^Wm, Rb^Gvs, Rb^Gvs, Rb^Gvs, Rb^Gvs, Rb^Gvs, Gg^Eff, Gg^Eff, Gg^Efm, Gs, Gs, Gg^Efm, Gg^Efm, Gg^Efm, Rr, Rr, Ch, Ch, Gg, Gg, Rr^Vhc, Rr, Ww, Ww, Rr, Gs^Fds, Rr^Vhc, Gg, Wwf, Xof, Rr, Gg, Gs^Fds, Gs^Fds, Gs^Fds, Gg, Rr, Xof, Ww, Gg, Gg, Gg^Fds, Gg^Fds, Gs, Gg^Fds, Gg^Fds, Hh, Mm, Mm, Mm
Gg^Efm, Gg^Efm, Rb^Gvs, Rb^Gvs, Rb^Gvs, Rb^Gvs, Rb^Gvs, Rb^Gvs, Rb^Gvs, Rb^Gvs, Rb^Gvs, Rb^Gvs, Rb^Gvs, Rb^Gvs, Rb^Gvs, Rb^Gvs, Rb^Gvs, Rb^Gvs, Rb^Gvs, Rb^Gvs, Rb^Gvs, Gg^Eff, Gs^Efm, Gs, Gs^Efm, Gg^Efm, Gg^Efm, Gg^Efm, Gg^Efm, Rr, Rr, Rr^Vhc, Gs^Fds, Gg, Rr, Gg^Ebn, Ww, Gs^Fds, Ww, Gs^Fds, Gs^Fds, Gg, Rr^Vhc, Rr, Rr, Gg, Rr^Vhc, Gg, Rr, Rr, Xof, Ww, Gs, Gg, Gg^Fds, Gg^Fds, Gs, Gg^Fds, Gg^Fds, Hh^Fds, Hh^Fds, Mm, Hh
Gg, Gg, Rb^Gvs, Rb^Gvs, Rb^Gvs, Rb^Gvs, Rb^Gvs, Rb^Gvs, Rb^Gvs, Rb^Gvs, Hh^Fds, Rb^Gvs, Rb^Gvs, Rb^Gvs, Rb^Gvs, Rb^Gvs, Rb^Gvs, Rb^Gvs, Rb^Gvs, Rb^Gvs, Rb^Gvs, Gg, Gg, Gs, Gs, Gs, Gs, Gg^Efm, Gs, Gs, Gs, Rr, Rr, Rr^Vhc, Rr, Gg, Rr^Vhc, Ww, Ww, Ww, Ww, Gg, Rr, Rr, Ds, Rr, Rr, Rr, Ch, 3 Kh, Ch, Gg, Rd, Gg, Gs, Gs, Gs, Gg^Fds, Gg^Fds, Gg^Fds, Hh^Fds, Hh^Fds, Hh
Gg, Gg, Rb^Gvs, Rb^Gvs, Rb^Gvs, Rb^Gvs, Rb^Gvs, Rb^Gvs, Rb^Gvs, Hh^Fds, Mm, Hh^Fds, Hh, Rb^Gvs, Rb^Gvs, Rb^Gvs, Rb^Gvs, Rb^Gvs, Rb^Gvs, Rb^Gvs, Rb^Gvs, Gg, Gg, Gs, Gs^Efm, Gs, Gs, Gs, Gs^Efm, Gs, Gs, Rr^Vhc, Rr, Rr, Rr, Rr, Rr, Rr, Rr, Rr^Vhc, Rr, Ww^Bsb/, Ww, Ww, Ww, Ds, Gg, Rr, Rd, Ch, Rd, Rd, Gs, Re, Rb, Gs, Ss, Gg^Fds, Gs^Fds, Hh^Fds, Hh^Fds, Hh^Fds, Gs^Fds
Gg, Gg, Rb^Gvs, Rb^Gvs, Rb^Gvs, Rb^Gvs, Rb^Gvs, Rb^Gvs, Rb^Gvs, Hh, Hh^Fds, Rb^Gvs, Hh, Rb^Gvs, Rb^Gvs, Rb^Gvs, Rb^Gvs, Rb^Gvs, Rb^Gvs, Rb^Gvs, Rb^Gvs, Gg, Gg, Gg, Gg^Efm, Gg, Gs^Fds, Gs, Gs, Gs, Rr, Rr, Hh^Fds, Hh, Hh, Hh, Hh, Hh, Hh, Rr, Gg, Gg, Gg^Ebn, Ww, Ww, Ds, Gg, Rr, Gg, Rd, Gg, Gs, Gs, Gs, Ss, Ss^Vhs, Ss, Ss, Gs^Fds, Gs^Fds, Gs^Fds, Gs^Fds, Gs^Fds
Gs^Fds, Gg, Rb^Gvs, Rb^Gvs, Rb^Gvs, Rb^Gvs, Rb^Gvs, Rb^Gvs, Rb^Gvs, Hh, Rb^Gvs, Rb^Gvs, Rb^Gvs, Rb^Gvs, Rb^Gvs, Rb^Gvs, Rb^Gvs, Rb^Gvs, Rb^Gvs, Rb^Gvs, Gg, Gg, Gg^Eff, Gg^Efm, Gg^Efm, Gg^Efm, Gg^Efm, Gs^Fds, Rr, Rr, Gg^Fds, Hh^Fds, Hh^Fds, Mm, Mm, Mm^Vhh, Mm, Mm, Hh, Rr^Vhc, Gg, Gg, Gg, Ww, Ww, Gg^Ebn, Gg, Rr, Gg, Gg, Gs, Gs, Gs, Gg, Ss, Ss, Ss, Ss, Gs^Fds, Gs^Fds, Gs^Fds, Gs^Fds, Gs^Fds
Gs^Fds, Gg, Gg, Rb^Gvs, Rb^Gvs, Rb^Gvs, Rb^Gvs, Rb^Gvs, Rb^Gvs, Rb^Gvs, Rb^Gvs, Rb^Gvs, Rb^Gvs, Rb^Gvs, Rb^Gvs, Rb^Gvs, Rb^Gvs, Rb^Gvs, Gg, Gg, Gg^Eff, Gg^Eff, Gg, Gg, Rr^Vhc, Gg^Efm, Rr, Rr, Xof, Gg, Gg^Fds, Gg^Fds, Gg^Fds, Hh^Fds, Hh^Fms, Mm, Mm, Mm, Mm, Hh, Gg, Gg, Ss, Ww, Ww, Gg, Rr^Vhc, Rr, Gg, Gg, Gg, Gg, Gg, Gg, Gs^Fds, Ss, Ss, Gs^Fms, Gs^Fms, Hh^Fds, Hh^Fds, Gs^Fms, Gs^Fds
Hh^Fds, Hh^Fds, Hh^Fds, Gg, Gg, Rb^Gvs, Rb^Gvs, Rb^Gvs, Rb^Gvs, Rb^Gvs, Rb^Gvs, Rb^Gvs, Rb^Fds, Rb^Gvs, Rb^Gvs, Rb^Gvs, Rb^Gvs, Gg^Wm, Gg^Eff, Gg^Eff, Gg, Gg, Gg, Ch, Rr, Rr, Xof, Xof, Gg, Gg, Gg^Fds, Gg^Fds, Hh^Fms, Gg^Fms, Gg^Fms, Hh^Fds, Hh^Fds, Mm, Hh^Fds, Hh, Gg, Gg, Ss, Ww, Ww, Ww, Ww, Rr, Rr^Vhc, Gg, Gg, Gg, Gg, Gs^Fds, Ss, Ss, Hh^Fds, Hh^Fds, Hh^Fds, Hh^Fds, Gs^Fds, Gs^Fms, Gs^Fds
Hh^Fds, Hh^Fds, Hh^Vhr, Gs^Fds, Gg, Gg^Wm, Rb^Gvs, Rb^Gvs, Rb^Gvs, Rb^Gvs, Rb^Gvs, Rb^Fds, Rb^Gvs, Rb^Gvs, Rb^Gvs, Rb^Gvs, Rb^Gvs, Gg^Eff, Gg, Xof, Xof, Gg, Ch, 6 Kh, Ch, Rr, Xof, Gg, Gg, Gg^Fds, Gg^Fds, Hh^Fds, Hh^Fds, Hh^Fds, Hh^Fms, Gg^Fds, Gg^Fds, Hh^Fds, Gg^Fds, Gg, Gg, Gg, Gg, Ss, Ss, Ww, Ss, Ww^Bsb|, Ww, Ss, Ss, Gg, Gs^Fds, Gs^Fds, Gs^Fds, Gs^Fds, Hh^Fds, Gs^Fds, Gs^Fms, Gs^Fms, Gs^Fds, Gs^Fds, Gs^Fds
Gs^Fds, Hh^Fds, Gs^Fds, Gs^Fds, Gg, Gg, Rb^Gvs, Rb^Gvs, Rb^Gvs, Rb^Gvs, Rb^Gvs, Rb^Gvs, Rb^Gvs, Rb^Gvs, Rb^Gvs, Rb^Gvs, Gg, Gg, Gg, Gg, Gg, Gg, Gg^Efm, Rr^Vhc, Rr, Rr, Gg, Gg, Gg, Gg^Fds, Gg^Fds, Gg^Fds, Gg^Fds, Gg^Fds, Hh^Fds, Gg^Fds, Gg^Fds, Gg^Fds, Gg, Gg, Gg, Gg, Gg, Gg, Gg, Ss, Gg, Rr, Ww, Ss, Gs^Fds, Gs^Fds, Gs^Fds, Gs^Fds, Gs^Fds, Gs^Fds, Hh^Fds, Hh^Fms, Gs^Fds, Gs^Fds, Gs^Fds, Gs^Fds, Gs^Fds
Gs^Fds, Gs^Fds, Gs^Fms, Gs^Fds, Gs^Fms, Gg, Gg, Rb^Gvs, Rb^Gvs, Rb^Gvs, Rb^Gvs, Rb^Gvs, Gg, Rb^Gvs, Gg, Gg, Gg, Gg, Gs^Efm, Gg, Gg^Efm, Gg^Efm, Gg^Efm, Rr, Rr^Vhc, Gg, Gg, Gg, Gg, Gg^Fds, Gg^Fds, Gg^Fds, Gg^Fds, Gs^Vl, Gg^Fds, Gg^Fds, Gg^Fds, Gg^Fds, Gg, Gg, Gg, Gg, Gg, Gg, Gg, Gg, Gs^Vh, Rr, Ww, Chw, Ww, Gs^Fds, Ww, Gs^Fms, Gs^Fds, Hh^Fds, Gs^Fms, Gs^Fds, Hh^Fds, Hh^Fds, Gs^Fms, Gs^Fds, Gs^Fds
Hh^Fds, Gs^Fms, Gs^Fds, Gs^Fms, Gs^Fds, Gs^Fds, Gg, Gg, Gg, Gg, Gg, Gg, Gs^Efm, Gg, Gs, Gg, Gs^Efm, Gs^Efm, Gg, Gg^Efm, Gg^Efm, Gg^Efm, Rr, Rr, Gg, Gg, Gg, Gg, Gg, Gg, Gg, Gg^Fds, Gg, Gg^Fds, Gg, Gg^Fds, Gg^Fds, Gg, Gg, Gg, Gg, Gg, Gg, Gg, Rr, Rr, Rr, Rr, Re, Ww, Gs^Fds, Ww, Gs^Fms, Ww, Ww, Ww, Ww, Ww, Ww, Hh^Fds, Gs^Fds, Gs^Fds, Ww
Hh, Hh^Fds, Hh, Gs^Fds, Gs^Fds, Gs^Fds, Gs^Fms, Gg, Gg, Gg, Gg, Gs^Efm, Gs^Efm, Gs^Efm, Gs^Efm, Gs^Efm, Gs^Efm, Gg^Efm, Gg^Efm, Gg^Efm, Gg^Efm, Rr, Rr, Gg, Gg, Gg, Gg, Gg, Gs^Fds, Gg, Gg, Gg, Gg, Gg, Gg, Gg, Gg, Gg, Gg, Gg, Gg, Gg, Rr, Rr, Gs^Fds, Gs^Fds, Gs^Fds, Gs^Fds, Gs^Fms, Re, Re, Hh^Fms, Re, Gs^Fds, Gs^Vl, Gs^Fds, Gs^Fms, Gs^Fds, Gs^Fms, Ww, Ww, Ww, Ww
Hh, Hh^Fds, Hh^Fds, Gs^Fds, Hh, Hh^Fds, Gs^Fms, Gg, Gs^Vc, Gg, Gs^Efm, Gs^Efm, Gs^Efm, Gs, Gg, Gs, Gg, Gg, Gg, Gg^Efm, Rr, Rr, Gg, Gg, Gg, Gg, Gg, Gg, Hh^Fds, Gs^Fds, Gs^Fds, Gg, Gs^Fds, Gs^Fds, Gs^Fms, Gs^Fds, Gs^Fds, Gg, Gg, Gg, Gg, Gs^Vh, Rr, Gs^Fds, Gs^Fms, Hh^Fms, Hh^Fms, Hh^Fms, Gs^Fds, Gs^Fds, Hh^Fds, Re, Re, Re, Re, Gs^Fms, Gs^Fds, Gs^Fms, Gs^Fds, Ww, Ww, Wo, Wo
Hh, Hh, Hh, Hh, Hh, Hh^Fds, Gg, Gs, Gs, Gs, Gs^Efm, Gs^Efm, Gs, Gg, Gg, Gg, Gg, Gg, Rr, Rr, Gg, Gg, Gg, Gg, Gg, Gg, Gg, Gs^Fds, Hh^Fds, Hh^Fds, Hh^Fms, Hh^Fms, Gg^Fms, Gs^Fms, Gg^Fds, Gs^Fms, Gs^Fds, Gs^Fds, Gs^Fds, Gg, Gg, Gg, Rr, Gs^Fds, Gs^Fds, Hh^Fds, Gs^Fds, Gs^Fds, Gs^Fds, Gs^Fds, Gs^Fds, Gs^Fds, Gs^Fds, Gs^Fds, Gs^Fds, Re, Re, Gs^Fds, Gs^Fds, Ww, Ww, Wo, Wo
