Md, Md, Md, Md, Md, Md, Md, Md, Md, Md, Md, Md, Md, Md, Md, Ww, Md, Md, Md, Md, Md, Md, Md
Md, Md, Md, Md, Wwf, Hh^Fds, Hh^Fds, Hh^Fds, Hh^Fds, Md, Hh^Fp, Md, Hh^Fms, Md, Ww, Ww, Hh^Fds, Md, Hh^Fp, Md, Md, Md, Md
Md, Md, Hh^Fp, Hh^Fp, Wwf, Wwf, Hh^Fds, Hh^Fds, Hh^Fp, Hh^Fds, Hh^Fds, Hh^Fp, Hh^Fp, Hh^Fds, Ww, Hh^Fp, Hh^Fp, Hh^Fds, Hh^Fp, Hh^Fms, Hh^Fetd, Md, Md
Hh^Fms, Hh^Fds, Hh^Fds, Hh^Fp, Hh^Fms, Wwf, Gs^Fds, Gs^Fds, Gs^Fds, Hh^Fp, Gs^Fds, Gs^Fp, Gs^Fms, Gs^Fp, Wwf, Gs^Fp, Gs^Fds, Hh^Fp, Hh^Fp, Hh^Fp, Hh^Fp, Hh^Fms, Hh^Fms
Hh^Fms, Hh^Fds, Hh^Fms, Hh^Fds, Hh^Fp, Hh^Fds, Gs^Fp, Gs^Fds, Gs^Efm, Gs^Fms, Ss, Ss, Ss, Wwf, Gs, Gs^Fms, Gg^Efm, Gs^Fds, Gs^Es, Gs^Fp, Gs^Fms, Hh^Fms, Gs^Fms
Ww, Hh^Fms, Ww, Hh^Fds, Gs^Fp, Hh^Fetd, Gs^Efm, Gs^Fp, Gg^Efm, Gs^Fp, Ss, Ss, Ss, Wwf, Gs^Fp, Gs^Efm, Mm, Gg, Gs^Fp, Gs^Fds, Gs^Fds, Gs^Fds, Gs^Fds
Ww, Ww, Ww^Ewl, Gs^Fds, Mm, Mm, Mm, Gg^Efm, Gg^Efm, Gg^Efm, Gs^Fms, Gs^Fms, Ww, Ww, Hh^Fms, Hh^Fms, Mm, Mm, Mm, Gs^Fms, Gs^Fds, Gs^Fds, Gs^Fms
Ww, Ww, Gg^Efm, Gg^Efm, Mm, Mm, Hh^Fp, Gs^Efm, Gs^Efm, Gs^Fms, Re, Gs^Fms, Ww, Gs^Fms, Hh^Em, Hh^Em, Hh^Tf, Hh^Fms, Hh, Mm, Ss, Gs^Fds, Gs^Fms
Gs^Fms, Gs^Fp, Gs^Fds, Hh^Fds, Mm, Mm, Gs^Fms, Gs^Fms, Gs^Fms, Gs^Efm, Re, Re, Ce, Ww, Gg^Em, Gg^Tf, Gg^Tf, Hh^Em, Ss, Ss, Ss, Ss, Gs^Fms
Gs^Fp, Gs^Fp, Gs^Fp, Mm, Hh^Fms, Gs^Fms, Gg, Ss, Ss, Ss, Re^Ecf, Gg^Fp, Gg^Fp, Ww, Ww, Gg^Em, Gg^Em, Gg^Em, Gg, Ss, Hh^Fds, Gs^Fds, Gs^Fms
Gs^Fms, Gs^Fp, Gs^Fp, Mm, Hh, Hh, Gg, Gg, Gg^Fp, Gg^Fp, Re^Edb, Re^Vct, Re^Vct, Gd^Ecf, Ds, Ww, Gd, Gd, Gg, Gg, Hh^Fds, Hh^Fds, Gs
Gs^Fms, Gs^Fp, Gs^Fms, Hh, Gg, Gg, Gg, Ce, Gg^Fp, Re^Vct, Re^Ecf, Re, Ds^Edt, Ds^Ecf, Ds, Ww, Ds, Gg, Gg, Hh, Hh, Hh, Gg
Gg, Gs^Fms, Gg, Gg, Gg^Es, Gs, Ds, Ds, Ds^Ecf, Ds, Ds, Ds, Ds, Ds^Vct, Ce, Ww, Ds, Ds, Hd, Hh, Hd, Ds^Esd, Ds
Gg, Gg, Ds, Ds, Ds, Ds, Ds, Ds, Ds^Vct, Ds, Wwf, Ds, Wwf, Ds, Wwf, Ww, Ds, Ds^Esd, Ds, Hd, Ds, Ds, Ds
Ds, Ds, Ds, Ds, Ds, Ds, Wwf, Ce, Wwf, Wwf, Wwf, 1 Wwf, Wwf, Wwf, Ww, Ww, Wwf, Ds, Wwf, Ds, Ds, Ds^Esd, Ds
Ds, Ds, Wwf, Wwf, Wwf, Wwf, Ww, Wwf, Ww, Ww, Ww, Wwf, Ww, Ww, Ww, Ww, Wwf, Wwf, Ww, Wwf, Wwf, Wwf, Wwf
Wwf, Wwf, Ww, Ww, Ww, Ww, Ww, Ww, Wo, Ww, Ww, Ww, Ww, Ww, Wo, Ww, Ww, Ww, Ww, Ww, Ww, Ww, Ww
Ww, Ww, Ww, Ww, Ww, Ww, Ww, Ww, Wo, Wo, Wo, Wo, Wo, Wo, Wo, Ww, Ww, Ww, Ww, Ww, Ww, Ww, Ww
