Wo, Wo, Wo, Wo, Wo, Wo, Wo, Wo, Wo, Wo, Wo, Wo, Wo, Wo, Wo, Wo, Wo, Wo, Wo, Wo, Wo, Wo, Wo, Wo, Wo, Wo, Wo, Wo, Wo, Wo, Ww, Ww, Ww, Ww, Ww, Gg, Gs^Fms, Gs^Fms, Gs^Fms, Gs^Fms, Gs^Fds, Gs^Fds, Gs^Fms, Gs^Fms, Gs^Fms, Gg, Ww, Gg^Em, Gg^Em, Gs^Fms, Gs^Fms, Gs^Fms
Wo, Wo, 1 Wo, Wo, Wo, Wo, Wo, Wo, Wo, Wo, Wo, Wo, Wo, Wo, Wo, Wo, Wo, Wo, Wo, Wo, Wo, Wo, Wo, Wo, Wo, Wo, Wo, Wo, Wo, Wo, Ds, Ds, Gg, Gg, Gs^Fms, Ww, Ww, Gg, Gg, Gs^Fms, Gg^Efm, Gs^Fds, Gg^Efm, Gs^Fms, Gg, Gg, Ww, Ww, Gg^Em, Gs^Fms, Gs^Fms, Gs^Fms
Wo, Wo, Wo, Wo, Wo, Wo, Wo, Wo, Wo, Wo, Wo, Wo, Wo, Wo, Wo, Wo, Wo, Wo, Wo, Wo, Wo, Wo, Wo, Wo, Wo, Wo, Wo, Wo, Wo, Ww, Ds, Ds, Gg, Gs^Fms, Gs^Fms, Gs^Vh, Wwf, Ww, Ww, Gs^Vc, Gg, Gg^Efm, Gg^Efm, Gg, Gg, Ww, Ww, Ww, Ww, Gg^Vhr, Gs^Fms, Gs^Fms
Wo, Wo, Wo, Wo, Wo, Wo, Wo, Wo, Wo, Wo, Wo, Wo, Wo, Wo, Wo, Wo, Wo, Wo, Wo, Wo, Wo, Wo, Wo, Wo, Wo, Wo, Wo, Wo, Wo, Ww, Gd, Ds, Gs^Fms, Gs^Fms, Gs^Fms, Gs, Gs, Wwf, Wwf, Ww, Ww^Bw/, Gg, Ww, Mm, Ww^Bw|, Ww, Ww, Ww, Ww, Ww, Gs^Fds, Gs^Fms
Wo, Wo, Wo, Wo, Wo, Wo, Wo, Wo, Wo, Wo, Wo, Wo, Wo, Wo, Wo, Wo, Wo, Wo, Wo, Wo, Wo, Wo, Wo, Wo, Wo, Wo, Wo, Wo, Ww, Ww, Gd, Gd, Gs^Fms, Gs^Fds, Gs^Fds, Gs, Gg, Gg, Re, Re, Gg, Ww, Hh^Fms, Ww, Gg, Ce, Ce, Ww, Ce, Gs^Fdw, Gs^Fds, Gs^Fms
Wo, Wo, Wo, Wo, Wo, Wo, Wo, Wo, Wo, Wo, Wo, Wo, Wo, Wo, Wo, Wo, Wo, Wo, Wo, Wo, Wo, Wo, Wo, Wo, Wo, Wo, Wo, Wo, Ww, Gd, Gd, Gd, Gs^Vh, Gs^Fds, Gs^Fds, Gs^Fds, Hh^Fms, Re, Hh, Hh^Vl, Hh, Gg, Gg, Ww, Gg, Gg^Ecf, Ce, Ce, 4 Ke, Gs^Fdw, Gs^Fds, Gs^Fms
Wo, Wo, Wo, Wo, Wo, Wo, Wo, Wo, Wo, Wo, Wo, Wo, Wo, Wo, Wo, Wo, Wo, Wo, Wo, Wo, Wo, Wo, Wo, Wo, Wo, Wo, Wo, Wo, Wo, Ww, Ds, Gd, Gs^Fms, Gs^Fms, Gg, Gg^Fms, Hh^Fms, Re, Mm, Hh, Mm, Mm, Mm, Wwf, Hh^Fms, Hh, Ce, Gs^Fdw, Gg^Ecf, Gs^Fdw, Hh^Fdw, Hh
Wo, Wo, Wo, Wo, Wo, Wo, Wo, Wo, Wo, Wo, Wo, Wo, Wo, Wo, Wo, Wo, Wo, Wo, Wo, Wo, Wo, Wo, Wo, Wo, Wo, Wo, Wo, Wo, Wo, Wo, Ds, Gg, Gg, Gs^Fms, Gg, Gg, Gg, Re, Mm, Mm, Mm, Mm, Hh^Fms, Mm, Mm, Hh, Hh^Fdw, Gg, Rd, Hh^Fdw, Hh, Hh
Wo, Wo, Wo, Wo, Wo, Wo, Wo, Wo, Wo, Wo, Wo, Wo, Wo, Wo, Wo, Wo, Wo, Wo, Wo, Wo, Wo, Wo, Wwr, Wo, Wo, Wo, Wo, Wo, Wo, Wo, Ds, Gs^Vh, Gg, Gg, Hh^Fds, Gg, Gg, Re, Re, Hh, Gs^Fms, Hh, Hh^Tf, Hh^Fms, Mm, Hh^Fms, Hh^Fms, Gs^Vc, Rd, Gs^Fms, Hh, Hh
Wo, Wo, Wo, Wo, Wo, Wo, Wo, Wo, Wo, Wo, Wo, Wo, Wo, Wo, Wo, Wo, Wo, Wo, Wo, Wo, Wo, Wwr, Wwr, Wwr, Wo, Wo, Wo, Wo, Wo, Wo, Ww, Ds, Ds, Gg, Hh, Hh^Fds, Hh^Fms, Gs^Fms, Gs^Fms, Re, Hh, Hh, Mm, Mm, Gs^Fms, Mm, Gs^Fds, Gs^Fms, Rd, Gs^Fms, Gs^Fms, Gg
Wo, Wo, Wo, Wo, Wo, Wo, Wo, Wo, Wo, Wo, Wo, Wo, Wo, Wo, Wo, Wo, Wo, Wo, Wo, Wo, Wo, Wo, Wo, Wwr, Wwr, Wo, Wo, Wo, Wo, Ww, Ds, Ds, Gg, Gg, Gs^Fms, Hh^Fds, Gs^Fms, Gs^Fms, Ss, Re, Hh, Mm, Hh^Tf, Gs^Fms, Gs^Fms, Gs^Fds, Hh, Rd, Ss, Gs^Fms, Gs^Fms, Gg
Wo, Wo, Wo, Wo, Wo, Wo, Wo, Wo, Wo, Wo, Wo, Wo, Wo, Wo, Wo, Wo, Wo, Wo, Wo, Wo, Wo, Wo, Wo, Wo, Wo, Wo, Wo, Wo, Ww, Ww, Gg, Gg, Gs^Fms, Gs^Fms, Gs^Fms, Gs^Fms, Gs^Fms, Gs^Fms, Ss, Re, Gg, Hh, Hh^Fds, Gs^Fms, Hh^Fms, Gs^Fds, Rd, Rd, Gs^Fms, Ss, Gs^Fms, Gg
Wo, Wo, Wo, Wo, Wo, Wo, Wo, Wo, Wo, Wo, Wo, Wo, Wo, Wo, Wo, Wo, Wo, Wo, Wo, Wo, Wo, Wwr, Wwr, Wo, Wo, Wo, Wo, Wo, Ww, Ww, Gg, Gg, Gg, Gs^Vh, Ss, Gs^Fms, Ss, Ss, Gs^Fds, Re, Re, Hh, Hh^Fds, Hh^Fms, Hh^Fms, Gs^Fms, Rd, Gs^Fds, Gs^Fms, Ss, Gs^Fms, Gg
Wo, Wo, Wo, Wo, Wo, Wo, Wo, Wo, Wo, Wo, Wo, Wo, Wo, Wo, Wo, Wo, Wo, Wo, Wo, Wo, Wo, Wwr, Wwr, Wo, Wo, Wo, Wo, Ww, Ww, Gs, Gs, Gs, Gs, Gg, Gg, Ss, Ss, Ss, Gs^Fms, Gg, Gs^Fds, Re, Re, Gg, Gg, Rd, Gg, Gs^Fms, Gs^Fms, Gs^Fms, Gg^Em, Gg
Wo, Wo, Wo, Wo, Wo, Wo, Wo, Wo, Wo, Wo, Wo, Wo, Wo, Wo, Wo, Wo, Wo, Wo, Wo, Wo, Wo, Wo, Wo, Wo, Wo, Wo, Wo, Ww, Ww, Gg, Gg, Gg, Gg^Efm, Gg, Gg^Efm, Gg, Gg, Gg, Gg, Gg, Gs^Fds, Gs, Rp, Gg^Vhr, Rb^Gvs, Rb^Gvs, Rb^Gvs, Gg, Ss, Ss, Gg^Em, Gg^Em
Wo, Wo, Wo, Wo, Wo, Wo, Wo, Wo, Wo, Wo, Wo, Wo, Wo, Wo, Wo, Wo, Wo, Wo, Wo, Wo, Wo, Wo, Wo, Wo, Wwr, Wwr, Wo, Wo, Ww, Gs^Vc, Gg, Gg, Gg^Efm, Gg^Efm, Gg, Gg^Efm, Gg^Efm, Gg^Efm, Gg, Gs, Gs^Fms, Gs, Rp, Rb^Gvs, Rb^Gvs, Rb^Gvs, Rb^Gvs, Rb^Gvs, Ss, Ss, Gg^Em, Gg^Em
Wo, Wo, Wo, Wo, Wo, Wo, Wo, Wo, Wo, Wo, Wo, Wo, Wo, Wo, Wo, Wo, Wo, Wo, Wo, Wo, Wo, Wo, Wo, Wo, Wwr, Wo, Wo, Wo, Wo, Ds, Ds, Gg, Gg, Gg, Ds, Ds, Ds, Gg^Efm, Ds, Gs^Fms, Gs^Fms, Gs, Rp, Rb^Gvs, Rp, Rb^Gvs, Rb^Gvs, Rb^Gvs, Rp, Gg^Em, Rb, Re
Wo, Wo, Wo, Wo, Wo, Wo, Wo, Wo, Wo, Wo, Wo, Wo, Wo, Wo, Wo, Wo, Wo, Wo, Wo, Wo, Wo, Wo, Wo, Wo, Wo, Wo, Wo, Wo, Wo, Wo, Wo, Ds, Ds, Gg, Ds, Ds, Ww, Ds, Ww, Ds, Gs^Es, Ss, Rrc, Ss, Wo, Rp, Rp, Rp, Gg, Rp, Gg, Gg
Wo, Wo, Wo, Wo, Wo, Wo, Wo, Wo, Wo, Wo, Wo, Wo, Wo, Wo, Wo, Wo, Wo, Wo, Wo, Wo, Wo, Wo, Wo, Wo, Wo, Wo, Wo, Wo, Wo, Wo, Wo, Ds, Ww, Ds, Ww, Ww, Ww, Ww, Wo, Wo, Wo, Ss, Rrc, Ss, Gg, Wo, Wo, Gg^Wm, Wo, Gg, Wo, Gg
Wo, Wo, Wo, Wo, Wo, Wo, Wo, Wo, Wo, Wo, Wo, Wo, Wo, Wo, Wo, Wo, Wo, Wo, Wo, Wo, Wo, Wo, Wo, Wo, Wo, Wo, Wo, Wo, Wo, Wo, Wo, Wo, Wo, Ww, Ww, Ww, Wo, Wo, Wo, Wo, Wo, Ss, Gg, Rrc, Gg^Es, Wo, Wo, Wo, Wo, Wo, Wo, Wo
Wo, Wo, Wo, Wo, Wo, Wo, Wo, Wo, Wo, Wo, Wo, Wo, Wo, Wo, Wo, Wo, Wo, Wo, Wo, Wo, Wo, Wo, Wo, Wo, Wo, Wo, Wo, Wo, Wo, Wo, Wo, Wo, Wo, Wo, Wo, Wo, Wo, Wo, Wo, Wo, Wo, Ww, Ww, Rrc, Wo, Wo, Wo, Wo, Wo, Wo, Wo, Wo
Wo, Wo, Wo, Wo, Wo, Wo, Wo, Wo, Wo, Wo, Wo, Wo, Wo, Wo, Wo, Wo, Wo, Wo, Wo, Wo, Wo, Wo, Wo, Wo, Wo, Wo, Wo, Wo, Wo, Wo, Wo, Wo, Wo, Wo, Wo, Wo, Wo, Wo, Wo, Wo, Ww, Ww, Ww, Wo^Bsb|, Wo, Wo, Wo, Wo, Wo, Wo, Wo, Wo
Wo, Wo, Wo, Wo, Wo, Wo, Wo, Wo, Wo, Wo, Wo, Wo, Wo, Wo, Wo, Wo, Wo, Wo, Wo, Wo, Wo, Wo, Wo, Wo, Wo, Wo, Wo^Cov, Wo^Cov, Wo^Cov, Wo, Wo, Wo, Wo, Wo, Wo, Wo, Wo, Wo, Wo, Ww, 2 Kh, Ww, Ch, Ch, Ch, Wo, Wo, Wo, Wo, Wo, Wo, Wo
Wo, Wo, Wo, Wo, Wo, Wo, Wo, Wo, Wo, Wo, Wo, Wo, Wo, Wo, Wo, Wo, Wo, Wo, Wo, Wo, Wo, Wo, Wo, Wo, Wo, Wo, Wo^Cov, 5 Wo^Kov, Wo^Cov, Wo, Wo, Wo, Wo, Wo, Chw, Wo, Ch, Wo, Wo^Bw/, Ch, Rr^Vhc, Ch, Gs, Rr^Vhc, Ch, Rr^Vhc, Wo, Wo, Wo, Wo, Wo, Wo
Wo, Wo, Wo, Wo, Wo, Wo, Wo, Wo, Wo, Wo, Wo, Wo, Wo, Wo, Wo, Wo, Wo, Wo, Wo, Wo, Wo, Wo, Wo, Wo, Wo, Wo, Wo, Wo^Cov, Wo, Wo, Wo, Wo, Wo, Wwr, Wwr, Rr^Vhc, Rrc, Rrc, Wo, Ch, Rrc, Gs^Fds, Rr^Vhc, Gs^Fds, Rrc, Ww, Wo, Wo, Wo, Wo, Wo, Wo
Wo, Wo, Wo, Wo, Wo, Wo, Wo, Wo, Wo, Wo, Wo, Wo, Wo, Wo, Wo, Wo, Wo, Wo, Wo, Wo, Wo, Wo, Wo, Wo, Wo, Wo, Wo, Wo, Wo, Wo, Wo, Wo, Wo, Wo, Wwr, Rrc, Rrc, Rrc, Wo^Bw/, Ch, Ch, Hh^Fds, Ch, Rrc, Rr^Vhc, Ch, Wo, Wo, Wo, Wo, Wo, Wo
Wo, Wo, Wo, Wo, Wo, Wo, Wo, Wo, Wo, Wo, Wo, Wo, Wo, Wo, Wo, Wo, Wo, Wo, Wo, Wo, Wo, Wo, Wo, Wo, Wo, Wo, Wo, Wo, Wo, Wo, Wo, Wo, Wo, Wo, Wo, Wwr, Rr^Vhc, Rrc, Ww, Ww, Ww, Rr^Vhc, Ww, Rrc, Rrc, Ch, Wo, Wo, Wo, Wo, Wo, Wo
Wo, Wo, Wo, Wo, Wo, Wo, Wo, Wo, Wo, Wo, Wo, Wo, Wo, Wo, Wo, Wo, Wo, Wo, Wo, Wo, Wo, Wo, Wo, Wo, Wo, Wo, Wo, Wo, Wo, Wo, Wo, Wo, Wo, Wo, Wo, Wo, Ww, Wo, Wo, Wo, Wo, Ww, Wo, Ch, Wo, Wo^Bsb\, Gg, Wo, Wo, Wo, Wo, Wo
Wo, Wo, Wo, Wo, Wo, Wo, Wo, Wo, Wo, Wo, Wo, Wo, Wo, Wo, Wo, Wo, Wo, Wo, Wo, Wo, Wo, Wo, Wo, Wo, Wo, Wo, Wo, Wo, Wo, Wo, Ds, Ds, Ds, Wo, Wo, Ww, Wo, Wo, Wo, Wo, Ds, Wo, Wo, Wo^Bsb|, Wo, Gg, Gg, Gs^Vh, Wo, Wo, Gs^Fds, Gg
Wo, Wo, Wo, Wo, Wo, Wo, Wo, Wo, Wo, Wo, Wo, Wo, Wo, Wo, Wo, Wo, Wo, Wo, Wo, Wo, Wo, Wo, Wo, Wo, Wo, Wo, Wo, Wo, Ds, Ds, Gg^Eff, Rb^Gvs, Rb^Gvs, Gs^Vh, Rb^Gvs, Ww, Wo, Wo, Ds, Ds, Hh^Fds, Hh, Hh, Rrc, Gg, Gg, Gg^Efm, Gg, Ww^Ewf, Gs^Fds, Gs^Fds, Gs^Fds
Wo, Wo, Wo, Wo, Wo, Wo, Wo, Wo, Wo, Wo, Wo, Wo, Wo, Wo, Wo, Wo, Wo, Wo, Wo, Wo, Wo, Wo, Wo, Wo, Wo, Wo, Ds, Ds, Gg, Gg, Gg^Efm, Gg^Eff, Gg^Eff, Rb^Gvs, Gg^Eff, Gg^Eff, Gg^Fds, Gg^Fds, Gg^Fds, Hh^Fds, Gg^Fds, Hh, Hh, Rrc, Gg, Gg^Efm, Gg, Gg^Efm, Ss, Gs^Fds, Gs^Fds, Gs^Fds
Wo, Wo, Wo, Wo, Wo, Wo, Wo, Wo, Wo, Wo, Wo, Wo, Wo, Wo, Wo, Wo, Wo, Wo, Wo, Wo, Ds, Wo, Ds, Wo, Ds, Wo, Ds, Gg, Gg^Efm, Gg^Efm, Wwf, Wwf, Ss, Gg, Gg, Gg, Gs, Gs^Fms, Gg, Gg, Gg, Gg, Rp, Rp, Gg, Gg, Gg, Ss, Gs^Fds, Gs^Fds, Gs^Fms, Gs^Fds
Wo, Wo, Wo, Wo, Wo, Wo, Wo, Wo, Wo, Wo, Wo, Wo, Wo, Wo, Wo, Wo, Wo, Wo, Wo, Wo, Ds, Ds, Ds, Ds, Ds, Ds, Gg, Gg, Gg^Efm, Gg^Efm, Wwf, Ss, Gs^Fds, Ss, Gs^Fds, Gs, Gs, Gs, Gs, Gs, Gg, Rp, Gs^Fds, Gs^Fds, Gs^Fds, Gs^Vh, Gs^Fds, Gs^Fds, Hh^Fds, Hh^Fms, Gs^Fds, Gs^Fds
Wo, Wo, Wo, Wo, Wo, Wo, Wo, Wo, Wo, Wo, Wo, Wo, Wo, Wo, Wo, Wo, Wo, Wo, Ds, Ds, Rd, Rd, Hd, Hd, Hd, Ds, Gs^Vh, Gg, Gs^Fds, Gs^Fds, Gs^Fds, Gs^Fds, Hh^Fds, Gs^Fds, Gs^Fdw, Gs^Fds, Gs^Fms, Gg, Gg, Gs, Gg, Rp, Gs^Fds, Gs^Fms, Gs^Fms, Gs^Fms, Hh^Fds, Hh^Fds, Gs^Fds, Hh^Fds, Gs, Gg
Wo, Wo, Wo, Wo, Wo, Wo, Wo, Wo, Wo, Wo, Wo, Wo, Wo, Wo, Wo, Wo, Wo, Ds, Ds, Ds^Vdt, Rd, Gd, Gd^Efm, Hd, Gs^Fds, Gs^Fds, Gs^Fds, Gs^Fds, Gs^Fms, Gs^Fds, Hh^Fdw, Hh^Fdw, Gs^Fdw, Hh^Fdw, Gs^Vct, Gs^Fdw, Gs^Fms, Gs^Fms, Gg, Gg, Gg, Rp, Gs^Fds, Gs^Fds, Gs^Fds, Gs^Fms, Gs^Fds, Gs^Fds, Gs^Fds, Gs^Fds, Gs, Gg
Wo, Wo, Wo, Wo, Wo, Wo, Wo, Wo, Wo, Wo, Wo, Wo, Wo, Wo, Wo, Wo, Wo, Ds, Ds, Rd, Gd, Gd^Efm, Gd^Efm, Gs^Fds, Gs^Fms, Gs^Fms, Hh^Fds, Gs^Fds, Hh^Fms, Hh^Fms, Gll^Ecf, Hh^Vct, Ce, Gll^Fdw, Gg^Ecf, Gs^Fdw, Gs^Fdw, Gs^Fds, Gg, Gs, Hh^Fms, Rd, Gg, Gs^Fms, Gg, Gs^Fds, Gg, Gg, Gs, Gs, Gg, Gg
Wo, Wo, Wo, Wo, Wo, Wo, Wo, Wo, Wo, Wo, Wo, Wo, Wo, Wo, Wo, Wo, Wo, Wo, Ds, Rd, Ds, Hd, Hd, Gs^Fds, Gs^Fms, Hh^Fms, Gs^Fds, Hh^Fds, Gs^Fdw, Gs^Fdw, Gll^Fdw, Ce, 3 Ket, Ce, Ce, Gg^Vct, Gg, Gg, Gs, Gs, Hh, Rd, Rd, Gg, Gg, Gg, Gg, Gg, Gs^Vh, Gg, Rd, Rd
Wo, Wo, Wo, Wo, Wo, Wo, Wo, Wo, Wo, Wo, Wo, Wo, Wo, Wo, Wo, Wo, Wo, Wo, Wo, Ds, Ds, Ds, Ds, Gs^Fms, Gs^Fms, Gs^Fms, Gs^Fms, Gs^Fds, Gs^Fdw, Gs^Vct, Gll^Fdw, Ce, Gg^Ecf, Gg, Gg^Vct, Gg, Gg^Efm, Gg, Gg, Gs, Rd, Rd, Gg, Rd, Rd, Rd, Rd, Rd, Rd, Rd, Gg, Gg
Wo, Wo, Wo, Wo, Wo, Wo, Wo, Wo, Wo, Wo, Wo, Wo, Wo, Wo, Wo, Wo, Wo, Wo, Wo, Wo, Wo, Ds, Ds, Ds, Ds, Gs^Fms, Gs^Fds, Gs^Fds, Gg, Gg, Gg, Gg^Efm, Gg^Efm, Gg^Efm, Gg^Efm, Gg^Efm, Gg^Efm, Gg^Efm, Rd, Rd, Gg, Gg, Gg, Gg, Gg, Gg, Gg, Gg, Gg, Gg, Gg, Gg
