Ai, Ai, Ai, Wo, Ai, Wo, Ai, Ai, Ai, Ai, Ai, Ai, Ai, Ai, Ai, Wo, Ai, Wo, Ai, Wo, Ai, Wo, Ai, Wo, Ai, Wo, Ai, Wo, Wo, Wo, Ai, Ai, Ai
Ai, Wo, Ai, Wo, Ai, Ai, Ai, Ai, Wo, Wo, Ai, Wo, Ai, Ai, Wo, Wo, Wo, Ai, Wo, Ai, Wo, Ai, Ai, Ai, Ai, Wo, Ai, Ai, Ai, Wo, Wo, Wo, Ai
Ai, Ai, Ai, Ai, Ai, Ai, Ai, Ai, Ai, Wo, Ai, Wo, Ai, Wo, Aa, Ai, Aa, Ai, Ai, Ai, Wo, Ai, Ai, Wo, Wo, Ai, Ai, Ai, Ai, Wo, Ai, Ai, Ai
Ai, Ai, Ai, Wo, Ai, Wo, Ai, Ai, Ai, Ai, Aa, Aa, Aa, Aa, Aa, Aa, Aa, Aa, Aa, Aa, Aa, Aa, Aa, Wo, Ai, Wo, Ai, Ai, Ai, Wo, Ai, Ai, Ai
Ai, Ai, Ai, Wo, Ai, Ai, Wo, Ai, Aa^Vct, Ai, Aa^Eff, Aa, Aa, Aa, Aa, Aa, Aa, Aa, Aa, Aa, Aa, Aa, Aa, Aa, Ai, Ai, Ai, Ai, Ai, Wo, Ai, Ai, Ai
Ai, Wo, Ai, Ai, Wo, Wo, 1 Wo, Ai, Aa, Aa, Aa^Fma, Aa^Eff, Rb, Aa, Rb, Aa, Rb, Ha, Ha, Aa, Ha, Ha, Aa, Aa, Aa, Wo, Aa, Wo, Ai, Ai, Ai, Wo, Wo
Ai, Ai, Ai, Wo, Ai, Wo, Aa, Aa, Rb, Rb, Rb, Rb, Ha^Fma, Rb, Rb, Rb, Ha, Rb, Rb, Ha, Rb, Ha, Ha, Aa, Aa, Aa, Aa, Wo, Ai, Wo, Ai, Ai, Ai
Ai, Wo, Wo, Wo, Aa, Aa, Rb, Aa^Ecf, Rb, Aa^Fma, Ha^Vca, Ha^Fma, Ha^Fma, Ha, Ha, Ha, Ha^Fma, Ms, Ms, Rb, Ms, Rb, Ha, Ha, Ha, Aa, Aa, Aa, Aa, Ai, Ai, Ai, Wo
Ai, Ai, Ai, Wo, Aa, Aa^Vct, Aa^Fma, Aa^Fma, Ha^Fma, Rb, Ha^Fma, Ha^Fma, Ha^Fma, Ha^Fma, Aa, Aa, Ms, Ms, Ms, Ms^Xm, Ms^Xm, Rb, Rb, Aa, Rb, Ha, Ha^Fpa, Aa, Aa, Aa^Fpa, Wo, Wo, Ai
Ai, Ai, Wo, Wo, Ai, Aa, Aa^Eff, Aa^Fma, Aa^Fma, Ha^Fma, Aa, Aa, Ha^Fpa, Ha^Fetd, Aa, Aa, Ms^Fma, Ms^Xm, Ms^Xm, Ms^Xm, Ms^Xm, Rb, Rb, Rb, Ha, Rb, Rb, Ha^Fpa, Aa^Fpa, Aa^Fpa, Aa^Fpa, Ai, Wo
Ai, Ai, Ai, Wo, Ai, Aa^Eff, Aa, Aa^Vct, Aa^Fma, Ha^Fma, Aa^Fma, Ha^Fpa, Ha^Fpa, Ha^Fpa, Ha^Fpa, Ha^Fpa, Ms, Ms^Xm, Ms^Xm, Ms^Xm, Ms^Xm, Rb, Ms, Ms, Ms, Ms, Ms^Voa, Ha, Ha, Aa^Fpa, Aa, Wo, Ai
Ai, Wo, Wo, Wo, Wo, Aa, Aa, Aa, Aa, Rb, Aa, Aa, Ha^Fpa, Ha^Fpa, Ww, Ww, Ww, Ms, Ms^Xm, Ms^Xm, Rb, Aa, Ms, Ms, Ms, Ha, Ha, Aa, Aa, Aa, Aa, Ai, Ai
Wo, Wo, Ai, Ai, Wo, Wo, Aa, Aa, Aa, Rb, Ww^Bw\r, Ww, Ww, Ww, Ms, Ms, Ms, Ms, Ms, Rb, Ms, Ms, Ms, Ms, Ha, Ha, Ha, Aa, Aa, Aa, Aa^Voa, Ai, Ai
Ai, Wo, Wo, Wo, Wo, Ai, Ai, Ai, Ai, Ww, Aa, Rb, Ha, Ha, Cer, Ms, Ms, Ms, Aa, Rb, Ms^Fpa, Ms^Fpa, Ha^Fpa, Ha, Ha, Ha^Vaa, Aa, Aa, Aa, Aa, Ai, Ai, Ai
Ai, Ai, Wo, Ai, Ai, Ww, Ww, Ai, Wo, Aa, Aa^Vhr, Rb, Ha, Ha, Ms, Ms, Ms, Rb, Ha, Ha^Fpa, Ha^Fpa, Ms^Fpa, Ha, Ha, Aa, Aa, Coa, Coa, 2 Koa, Ai, Ai, Ai, Wo
Ai, Ai, Ai, Ai, Ai, Wo, Ww, Ai, Wo, Aa, Aa, Aa, Aa, Ha, Ha, Ha, Ha, Rb, Ha, Ha, Ha^Fpa, Ha^Fpa, Ha, Aa, Aa, Coa, Coa, Ai, Ai, Ai, Wo, Ai, Ai
Wo, Ai, Ai, Wo, Wo, Ai, Wo, Ai, Wo, Ai, Wo, Aa, Aa, Ha, Aa, Ha, Aa, Ha, Aa, Aa^Fpa, Aa^Fpa, Aa^Fpa, Aa, Ha^Voa, Aa, Aa, Aa, Ai, Ai, Ai, Ai, Wo, Ai
Ai, Ai, Wo, Ai, Wo, Wo, Wo, Ai, Ai, Ai, Ai, Aa, Aa, Aa, Re, Re, Re, Aa, Aa, Aa, Re, Re, Re, Aa, Re, Re, Re, Wo, Wo, Wo, Ai, Ai, Wo
Ai, Wo, Wo, Wo, Wo, Ai, Wo, Ai, Wo, Ai, Ww, Ai, Wo, Aa, Ai, Ai, Ai, Wo, Ai, Ai, Ai, Re, Ai, Ai, Ai, Ai, Ai, Ai, Ai, Ai, Ai, Ai, Ai
Ai, Ai, Wo, Wo, Ai, Ai, Ai, Wo, Wo, Ww, Wo, Wo, Wo, Ai, Ai, Ai, Wo, Ai, Ai, Ai, Wo, Ai, Ai, Ai, Wo, Ai, Wo, Ai, Ai, Ai, Ai, Ai, Ai
Ai, Ai, Ai, Ai, Ai, Ai, Ai, Wo, Wo, Ai, Ai, Ai, Ai, Wo, Ai, Ai, Wo, Ai, Wo, Ai, Ai, Wo, Wo, Ai, Wo, Ai, Ai, Wo, Ai, Ai, Ai, Wo, Ai
Wo, Ai, Wo, Ai, Ai, Ai, Ai, Wo, Ai, Ai, Ai, Ai, Wo, Wo, Ai, Wo, Ai, Ai, Ai, Wo, Ai, Ai, Ai, Ai, Ai, Ai, Wo, Ai, Ai, Ai, Ai, Ai, Ai
