Wog, Wog, Wog, Wog, Wog, Ai, Wog, Wog, Wog, Ai, Ai, Wog, Ai, Wog, Wog, Ai, Ai, Ai, Ai, Ai, Wog, Wog, Wog, Ai, Wog, Ai, Ai, Wog, Wog, Ai, Wog, Wog, Ai, Wog, Wog, Ai, Ai, Ai, Wog, Ai, Ai, Ai, Ai, Wog, Ai, Ai
Wog, Wog, 1 Wog, Wog, Wog, Wog, Ai, Ai, Wog, Wog, Wog, Ai, Ai, Ai, Ai, Ai, Ai, Wog, Ai, Wog, Ai, Wog, Wog, Ai, Wog, Wog, Wog, Wog, Ai, Ai, Ai, Ai, Ai, Ai, Ai, Ai, Wog, Ai, Ai, Ai, Ai, Wog, Ai, Ai, Wog, Ai
Wog, Wog, Wog, Wog, Ai, Wog, Wog, Wog, Ai, Ai, Ai, Wog, Ai, Wog, Wog, Ai, Ai, Ai, Ai, Wog, Wog, Wog, Ai, Ai, Wog, Wog, Wog, Wog, Ai, Ai, Wog, Ai, Ai, Wog, Ai, Ai, Wog, Wog, Wog, Wog, Ai, Ai, Wog, Ai, Wog, Ai
Wog, Wog, Ai, Wog, Wog, Ai, Wog, Wog, Wog, Wog, Ai, Wog, Wog, Ai, Ai, Ai, Ai, Ai, Wog, Wog, Ai, Wog, Wog, Ai, Ai, Ai, Ai, Wog, Ai, Wog, Wog, Wog, Ai, Wog, Ai, Ai, Wog, Wog, Wog, Wog, Ai, Wog, Ai, Wog, Wog, Ai
Wog, Ai, Ai, Wog, Wog, Wog, Wog, Ai, Ai, Ai, Wog, Wog, Ai, Ai, Ai, Wog, Wog, Ai, Wog, Wog, Ai, Wog, Ai, Ai, Wog, Wog, Ai, Ai, Ai, Wog, Ai, Ai, Wog, Wog, Wog, Ai, Ai, Wog, Wog, Ai, Ai, Wog, Wog, Wog, Wog, Wog
Ai, Ai, Ai, Ai, Ai, Ai, Ai, Ai, Wog, Ai, Wog, Ai, Ai, Wog, Wog, Ai, Wog, Wog, Wog, Ai, Wog, Wog, Wog, Ai, Wog, Ai, Wog, Wog, Ai, Wog, Ai, Ai, Wog, Wog, Ai, Ai, Wog, Wog, Ai, Wog, Wog, Ai, Wog, Wog, Ai, Wog
Wog, Ai, Wog, Wog, Wog, Ai, Ai, Wog, Ai, Ai, Ai, Wog, Wog, Ai, Ai, Wog, Wog, Wog, Ai, Ai, Ai, Wog, Wog, Wog, Wog, Wog, Ai, Ai, Ai, Ai, Ai, Ai, Ai, Ai, Ai, Ai, Ai, Ai, Wog, Ai, Ai, Wog, Ai, Wog, Wog, Ai
Ai, Wog, Ai, Wog, Ai, Wog, Wog, Wog, Ai, Ai, Wog, Wog, Ai, Wog, Wog, Ai, Wog, Ai, Wog, Ai, Ai, Ai, Ai, Ai, Wog, Wog, Wog, Wog, Ai, Ai, Wog, Wog, Ai, Wog, Ai, Ai, Ai, Ai, Wog, Wog, Wog, Wog, Ai, Wog, Wog, Wog
Wog, Ai, Wog, Ai, Ai, Ai, Ai, Wog, Ai, Ai, Ai, Ai, Ai, Ai, Ai, Ai, Ai, Wog, Ai, Wog, Wog, Ai, Ai, Wog, Ai, Ai, Wog, Ai, Ai, Wog, Ai, Wog, Wog, Ai, Wog, Ai, Wog, Wog, Wog, Ai, Ai, Ai, Ai, Wog, Wog, Ai
Wog, Ai, Ai, Ai, Wog, Wog, Ai, Wog, Ai, Ai, Wog, Ai, Ai, Ai, Wog, Ai, Wog, Ai, Wog, Ai, Wog, Wog, Wog, Ai, Wog, Ai, Ai, Wog, Wog, Wog, Ai, Wog, Ai, Wog, Ai, Ai, Wog, Ai, Ai, Wog, Wog, Ai, Ai, Ai, Wog, Wog
Ai, Wog, Wog, Wog, Wog, Ai, Wog, Wog, Ai, Ai, Ai, Ai, Wog, Ai, Ai, Ai, Ai, Wog, Ai, Wog, Ai, Ai, Ai, Ai, Ai, Wog, Ai, Wog, Ai, Ai, Wog, Ai, Ai, Wog, Ai, Wog, Ai, Ai, Ai, Wog, Ai, Wog, Wog, Ai, Wog, Ai
Wog, Ai, Wog, Wog, Ai, Ai, Wog, Wog, Ai, Wog, Wog, Ai, Wog, Ai, Ai, Ai, Ai, Wog, Ai, Wog, Ai, Wog, Ai, Wog, Wog, Ai, Wog, Ai, Wog, Wog, Ai, Wog, Wog, Ai, Ai, Ai, Ai, Wog, Wog, Wog, Wog, Ai, Wog, Ai, Wog, Ai
Ai, Wog, Wog, Ai, Wog, Ai, Wog, Ai, Ai, Wog, Wog, Wog, Ai, Ai, Ai, Wog, Ai, Ai, Wog, Ai, Ai, Wog, Ai, Wog, Wog, Wog, Ai, Wog, Ai, Ai, Ai, Ai, Wog, Ai, Wog, Ai, Ai, Wog, Ai, Ai, Wog, Ai, Wog, Wog, Ai, Wog
Ai, Ai, Wog, Ai, Wog, Wog, Ai, Ai, Wog, Ai, Wog, Ai, Ai, Ai, Ai, Wog, Ai, Ai, Wog, Ai, Ai, Ai, Ai, Wog, Ai, Wog, Wog, Ai, Wog, Ai, Ai, Ai, Wog, Ai, Ai, Ai, Wog, Ai, Ai, Wog, Wog, Ai, Wog, Ai, Ai, Wog
Ai, Ai, Wog, Wog, Ai, Ai, Ai, Ai, Ai, Wog, Ai, Ai, Wog, Ai, Wog, Wog, Ai, Ai, Ai, Ai, Ai, Wog, Wog, Ai, Ai, Wog, Wog, Wog, Ai, Ai, Wog, Ai, Wog, Wog, Ai, Ai, Ai, Wog, Wog, Wog, Ai, Wog, Wog, Ai, Ai, Ai
Wog, Wog, Wog, Wog, Ai, Ai, Wog, Ai, Wog, Wog, Wog, Ai, Ai, Wog, Ai, Wog, Wog, Wog, Wog, Wog, Wog, Wog, Wog, Ai, Ai, Wog, Wog, Ai, Wog, Ai, Ai, Ai, Ai, Ai, Wog, Ai, Wog, Wog, Wog, Wog, Ai, Wog, Wog, Wog, Wog, Wog
Wog, Ai, Wog, Ai, Ai, Wog, Wog, Ai, Ai, Wog, Ai, Ai, Wog, Wog, Wog, Ai, Wog, Wog, Ai, Wog, Wog, Ai, Wog, Wog, Ai, Ai, Ai, Wog, Wog, Ai, Wog, Ai, Wog, Ai, Ai, Ai, Wog, Ai, Wog, Ai, Ai, Wog, Wog, Wog, Wog, Wog
Wog, Wog, Wog, Ai, Wog, Ai, Ai, Ai, Ai, Ai, Wog, Ai, Ai, Wog, Wog, Ai, Wog, Wog, Wog, Wog, Wog, Ai, Ai, Wog, Ai, Ai, Ai, Wog, Wog, Ai, Wog, Ai, Wog, Ai, Wog, Wog, Ai, Wog, Wog, Wog, Wog, Ai, Wog, Wog, Wog, Ai
Wog, Wog, Wog, Ai, Wog, Wog, Ai, Ai, Ai, Ai, Wog, Wog, Ai, Wog, Wog, Wog, Wog, Ai, Wog, Wog, Ai, Ai, Wog, Ai, Wog, Wog, Ai, Wog, Ai, Ai, Wog, Wog, Ai, Wog, Wog, Wog, Wog, Ai, Ai, Ai, Wog, Wog, Ai, Wo, Wo, Wo
Ai, Ai, Wog, Ai, Wog, Wog, Wog, Wog, Ai, Ai, Wog, Wog, Ai, Ai, Ai, Wog, Wog, Wog, Ai, Wog, Ai, Ai, Wog, Wog, Ai, Wog, Ai, Ai, Wog, Wog, Ai, Ai, Ai, Wog, Ai, Ai, Ai, Ai, Ai, Wog, Ai, Ai, Ai, Wo, Aa, Aa
Wog, Ai, Wog, Ai, Ai, Wog, Ai, Ai, Ai, Wog, Wog, Ai, Ai, Ai, Ai, Ai, Ai, Wog, Ai, Wog, Ai, Ai, Wog, Wog, Ai, Wog, Wog, Ai, Ai, Ai, Ai, Ai, Wog, Ai, Ai, Ai, Ai, Ai, Ai, Wog, Ai, Wog, Wo, Wo, Aa, Aa
Wog, Ai, Wog, Wog, Wog, Ai, Wog, Ai, Wog, Ai, Wog, Ai, Wog, Ai, Ai, Wog, Wog, Wog, Ai, Wog, Ai, Ai, Wog, Wog, Ai, Wog, Ai, Wog, Ai, Ai, Ai, Wog, Wog, Ai, Wog, Ai, Ai, Ai, Wog, Ai, Wo, Wo, Aa, Aa, Aa, Aa
Wog, Wog, Ai, Wog, Ai, Wog, Wog, Ai, Ai, Wog, Ai, Ai, Wog, Wog, Ai, Wog, Ai, Wog, Ai, Wog, Wog, Wog, Ai, Ai, Ai, Wog, Wog, Ai, Wog, Ai, Ai, Ai, Ai, Ai, Ai, Wog, Wog, Ai, Ai, Wo, Wo, Wo, Aa, Aa, Aa, Aa
Ai, Ai, Wog, Wog, Wog, Wog, Wog, Wog, Wog, Wog, Wog, Wog, Wog, Ai, Ai, Wog, Wog, Wog, Wog, Ai, Wog, Wog, Ai, Wog, Ai, Ai, Wog, Wog, Ai, Wog, Ai, Wog, Wog, Ai, Wog, Ai, Ai, Ai, Wo, Wo, Aa, Aa, Aa, Aa, Aa, Aa
