Wog, Wog, Wog, Wog, Wog, Ai, Wog, Wog, Wog, Ai, Ai, Wog, Ai, Wog, Wog, Ai, Ai, Ai, Ai, Ai, Wog, Wog, Wog, Ai, Wog, Ai, Ai, Wog, Wog, Ai, Wog, Wog, Ai, Wog, Wog, Ai, Ai, Ai, Wog, Ai, Ai, Ai, Ai, Wog, Ai, Ai
Wog, Wog, 1 Wog, Wog, Wog, Wog, Ai, Ai, Wog, Wog, Wog, Ai, Ai, Ai, Ai, Ai, Ai, Wog, Ai, Wog, Ai, Wog, Wog, Ai, Wog, Wog, Wog, Wog, Ai, Ai, Ai, Ai, Ai, Ai, Ai, Ai, Wog, Ai, Ai, Ai, Ai, Wog, Ai, Ai, Wog, Ai
Wog, Wog, Wog, Wog, Ai, Wog, Wog, Wog, Ai, Ai, Ai, Wog, Ai, Wog, Wog, Ai, Ai, Ai, Ai, Wog, Wog, Wog, Ai, Ai, Wog, Wog, Wog, Wog, Ai, Ai, Wog, Ai, Ai, Wog, Ai, Ai, Wog, Wog, Wog, Wog, Ai, Ai, Wog, Ai, Wog, Ai
Wog, Wog, Ai, Wog, Wog, Ai, Wog, Wog, Wog, Wog, Ai, Wog, Wog, Ai, Ai, Ai, Ai, Ai, Wog, Wog, Ha, Wog, Wog, Ai, Ai, Ai, Ai, Wog, Ai, Wog, Wog, Wog, Ai, Wog, Ai, Ai, Wog, Wog, Wog, Wog, Ai, Wog, Ai, Wog, Wog, Ai
Wog, Ai, Ai, Wog, Wog, Wog, Wog, Ai, Ai, Ai, Wog, Wog, Ha, Aa, Ai, Wog, Wog, Ai, Wog, Wog, Ha, Wog, Ha, Ha, Wog, Wog, Ai, Ai, Ai, Wog, Ai, Ai, Wog, Wog, Wog, Ai, Ai, Wog, Wog, Ai, Ai, Wog, Wog, Wog, Wog, Wog
Ai, Ai, Ai, Wog, Ai, Ai, Ai, Ai, Wog, Ai, Wog, Ha, Aa, Wog, Wog, Ai, Wog, Wog, Wog, Ha, Wog, Wog, Wog, Aa, Wog, Ai, Wog, Wog, Ai, Wog, Ai, Ai, Wog, Wog, Ai, Ai, Wog, Wog, Ai, Wog, Wog, Ai, Wog, Wog, Ai, Wog
Wog, Ai, Wog, Wog, Wog, Ai, Ai, Wog, Ha, Aa, Aa, Wog, Wog, Ai, Ai, Wog, Wog, Wog, Ai, Aa, Ai, Wog, Wog, Wog, Wog, Wog, Ai, Ai, Ai, Ai, Ai, Ai, Ai, Ai, Ai, Ai, Ai, Ai, Wog, Ai, Ai, Wog, Ai, Wog, Wog, Ai
Ai, Wog, Ai, Wog, Ai, Wog, Wog, Wog, Ha, Ha, Wog, Wog, Ai, Wog, Wog, Wog, Wog, Ai, Wog, Ai, Ai, Ai, Ai, Ai, Wog, Wog, Wog, Wog, Ai, Ai, Wog, Wog, Ai, Wog, Ai, Ai, Ai, Ai, Wog, Wog, Wog, Wog, Ai, Wog, Wog, Wog
Wog, Ai, Wog, Ai, Ai, Ai, Ai, Wog, Aa, Aa, Ai, Ai, Ai, Ai, Ai, Wog, Wog, Wog, Ai, Wog, Wog, Ai, Ai, Wog, Ha, Ha, Wog, Ai, Ai, Wog, Ai, Wog, Wog, Ai, Wog, Ai, Wog, Wog, Wog, Ha, Ha, Ha, Ai, Wog, Wog, Ai
Wog, Ai, Ai, Ai, Wog, Wog, Ai, Wog, Ai, Ai, Wog, Ai, Ai, Ai, Wog, Aa, Wog, Ai, Wog, Ai, Wog, Wog, Wog, Wog, Wog, Ha, Aa, Wog, Wog, Wog, Ai, Wog, Ai, Wog, Ai, Ai, Wog, Ha, Ha, Wog, Wog, Ha, Ai, Ai, Wog, Wog
Ai, Wog, Wog, Wog, Wog, Ai, Wog, Wog, Ai, Ai, Ai, Ai, Wog, Aa, Ha, Ha, Aa, Wog, Ai, Wog, Ai, Ai, Wog, Wog, Ai, Wog, Ai, Wog, Ai, Ai, Wog, Ai, Ai, Wog, Ai, Wog, Ai, Ha, Ai, Wog, Ai, Wog, Wog, Ai, Wog, Ai
Wog, Ai, Wog, Wog, Ai, Ai, Wog, Wog, Wog, Wog, Wog, Ai, Wog, Aa, Aa, Ha, Ai, Wog, Ai, Wog, Ai, Wog, Ai, Wog, Wog, Ai, Wog, Ai, Wog, Wog, Ai, Wog, Wog, Ai, Ai, Ai, Ai, Wog, Wog, Wog, Wog, Ai, Wog, Ai, Wog, Ai
Ai, Wog, Wog, Ai, Wog, Ai, Wog, Ai, Ai, Wog, Wog, Wog, Ai, Wog, Wog, Wog, Ai, Ai, Wog, Ai, Ai, Wog, Ai, Wog, Wog, Wog, Ai, Wog, Ai, Ai, Ai, Ai, Wog, Ai, Wog, Ai, Ai, Wog, Ai, Ai, Wog, Ai, Wog, Wog, Ai, Wog
Ai, Ai, Wog, Ai, Wog, Wog, Ai, Ai, Wog, Ai, Wog, Ai, Ai, Ai, Ai, Wog, Ai, Ai, Wog, Ai, Ai, Ai, Ai, Wog, Ai, Wog, Wog, Ai, Wog, Ai, Ai, Ai, Wog, Ai, Wog, Wog, Wog, Ai, Ai, Wog, Wog, Ai, Wog, Ai, Ai, Wog
Ai, Ai, Wog, Wog, Ai, Ai, Ai, Ai, Ai, Wog, Ai, Ai, Wog, Ai, Wog, Wog, Ai, Ai, Ai, Ai, Ai, Wog, Wog, Ai, Ai, Wog, Wog, Wog, Ai, Ai, Wog, Ai, Wog, Wog, Ai, Ai, Ai, Wog, Wog, Wog, Ai, Wog, Wog, Ai, Ai, Ai
Wog, Wog, Wog, Wog, Ai, Ai, Wog, Ai, Wog, Wog, Wog, Ha, Ha, Wog, Ai, Wog, Wog, Wog, Wog, Wog, Wog, Wog, Wog, Ha, Ha, Wog, Wog, Ai, Wog, Ai, Ai, Ai, Ai, Ai, Wog, Ai, Wog, Wog, Wog, Wog, Ai, Wog, Wog, Wog, Wog, Wog
Wog, Ai, Wog, Ai, Ai, Wog, Wog, Ai, Ai, Wog, Ai, Ha, Wog, Wog, Wog, Ai, Wog, Wog, Ai, Wog, Wog, Ai, Wog, Wog, Ai, Ai, Ai, Wog, Wog, Ai, Wog, Ai, Wog, Ai, Ai, Ai, Wog, Ai, Wog, Ai, Ai, Wog, Wog, Wog, Wog, Wog
Wog, Wog, Wog, Ai, Wog, Ai, Ai, Ai, Ai, Ai, Wog, Ai, Ai, Wog, Wog, Ai, Wog, Wog, Wog, Wog, Wog, Ai, Ai, Wog, Ai, Ai, Ai, Wog, Wog, Ai, Wog, Ai, Wog, Ai, Wog, Wog, Ai, Wog, Wog, Wog, Wog, Ai, Wog, Wog, Wog, Ai
Wog, Wog, Wog, Ai, Wog, Wog, Ai, Ai, Ai, Ai, Wog, Wog, Ai, Wog, Wog, Wog, Wog, Ai, Wog, Wog, Ha, Ha, Wog, Ai, Wog, Wog, Ha, Wog, Ai, Wog, Wog, Wog, Ai, Wog, Wog, Wog, Wog, Ai, Ai, Ai, Wog, Wog, Ai, Wo, Wo, Wo
Ai, Ai, Wog, Ai, Wog, Wog, Wog, Wog, Ai, Ai, Wog, Wog, Ai, Ai, Ai, Wog, Wog, Wog, Ai, Wog, Ai, Ai, Wog, Wog, Ha, Wog, Ha, Ha, Wog, Wog, Ai, Ai, Wog, Wog, Ai, Ai, Ai, Ai, Ai, Wog, Ai, Ai, Ai, Wo, Aa, Aa
Wog, Ai, Wog, Ai, Ai, Wog, Ai, Ai, Ai, Wog, Wog, Ai, Ai, Ai, Ai, Ai, Ai, Wog, Ai, Wog, Ai, Ai, Wog, Wog, Ha, Wog, Wog, Ha, Ai, Ai, Ai, Ai, Wog, Ai, Ai, Ai, Ai, Ai, Ai, Wog, Ai, Wog, Wo, Wo, Aa, Aa
Wog, Ai, Wog, Wog, Wog, Ai, Wog, Ai, Wog, Ai, Wog, Ai, Wog, Ai, Ai, Wog, Wog, Wog, Ai, Wog, Ai, Ai, Wog, Wog, Ai, Wog, Ai, Wog, Wog, Wog, Wog, Wog, Wog, Wog, Wog, Ai, Wog, Wog, Wog, Ai, Wo, Wo, Aa, Aa, Aa, Aa^Fma
Wog, Wog, Ai, Wog, Ai, Wog, Wog, Ai, Ai, Wog, Ai, Ai, Wog, Wog, Ai, Wog, Ai, Wog, Ai, Wog, Wog, Wog, Ai, Ai, Ai, Wog, Wog, Ai, Wog, Wog, Ai, Wog, Ai, Ai, Ai, Wog, Wog, Ai, Ai, Wo, Wo, Wo, Aa, Aa, Aa^Fma, Ha^Fma
Ai, Ai, Wog, Wog, Wog, Wog, Wog, Wog, Wog, Wog, Wog, Wog, Wog, Ai, Ai, Wog, Wog, Wog, Wog, Ai, Wog, Wog, Ai, Wog, Ai, Ai, Wog, Wog, Ai, Wog, Ai, Wog, Wog, Ai, Wog, Ai, Ai, Ai, Wo, Wo, Aa, Aa, Aa^Fma, Aa^Fma, Ha^Fma, Ha^Fma
