Gs^Fms, Gs^Fds, Gs^Fds, Gs^Fds, Gs^Fds, Gs^Fms, Hh^Fds, Hh^Fds, Hh^Fp, Gs^Fds, Hh^Fds, Gs^Fds, Hh^Fds, Gs^Fds, Mm, Mm, Mm^Xm, Mm^Xm, Ms^Xm, Mm^Xm, Ms^Xm, Ms^Xm, Ms^Xm, Ms^Xm, Ms^Xm, Mm^Xm, Mm, Mm, Mm, Gs^Fds, Gs^Fms, Gs^Fds, Hh^Fds, Gs^Fds, Hh^Fms, Gs^Fms, Gs^Fms, Gs^Fds, Gs^Fms, Gs^Fds, Gs^Fds, Gs^Fms, Gs^Fds, Gs^Fms, Gs^Fds, Gs^Fms, Gs^Fds, Gll^Fp, Gs^Fds, Gs^Fds, Gs^Fms, Gs^Fds, Ww, Ww, Ww, Wo, Wo, Wo, Wo, Wo, Wo, Wo
Gs^Fds, Gs^Fds, Gs^Fds, Gs^Fms, Gs^Fds, Hh^Fds, Hh^Fms, Hh^Fms, Hh^Fds, Hh^Fds, Hh^Fds, Hh^Fds, Hh^Fds, Mm, Mm, Mm, Mm^Xm, Mm^Xm, Ms^Xm, Ms^Xm, Mm^Xm, Mm^Xm, Mm^Xm, Ms^Xm, Ms^Xm, Mm^Xm, Mm, Mm, Mm, Hh^Fds, Hh^Fms, Hh^Fds, Hh^Fms, Hh^Fds, Hh^Fds, Hh^Fms, Hh^Fds, Gs^Fds, Gs^Fms, Gs^Fms, Gs^Fds, Gs^Fds, Gs^Fds, Gs^Fds, Gs^Fds, Gll^Fp, Gs^Fms, Gs^Fds, Gs^Fms, Gs^Fms, Gs^Fds, Ww, Ww, Ww, Ww, Wo, Wo, Wo, Wo, Wo, Wo, Wo
Gs^Fds, Gs^Fds, Gs^Fds, Gs^Fds, Gs^Fds, Hh^Fds, Hh^Fms, Hh^Fds, Hh^Fds, Hh^Fms, Hh^Fms, Hh^Fds, Hh^Fds, Mm, Mm, Mm, Mm^Xm, Mm^Xm, Mm^Xm, Mm^Xm, Mm^Xm, Wog, Mm^Xm, Ms^Xm, Mm^Xm, Mm^Xm, Mm, Mm, Mm, Hh^Fds, Hh^Fds, Hh^Fds, Hh^Fds, Hh^Fms, Hh, Hh^Fds, Hh, Hh^Fds, Gs^Fds, Gs^Fds, Gs^Fds, Gs^Fds, Gs^Fms, Gs^Fms, Gs^Fds, Gs^Fds, Gs^Fms, Gs^Fds, Gs^Vct, Gs^Fds, Gs^Fds, Ww, Ww, Ww, Ww, Wo, Wo, Wo, Wo, Wo, Wo, Wo
Gs^Fms, Gs^Fds, Gs^Fds, Gs^Fds, Gs^Fms, Hh^Fds, Hh^Fds, Hh^Fds, Hh, Hh^Fds, Hh^Fds, Hh^Fds, Hh^Fms, Mm, Mm, Mm, Mm, Mm^Xm, Mm^Xm, Mm^Xm, Wog, Wog, Mm^Xm, Mm^Xm, Mm^Xm, Mm^Xm, Mm, Mm, Mm, Hh^Fds, Hh^Fds, Hh^Fds, Hh^Fds, Hh, Hh^Fds, Hh, Hh^Fms, Hh, Gs, Gs, Gg^Efm, Gs^Fds, Gg, Gs^Fds, Gs, Gs, Gs^Fms, Gs^Fds, Gs^Fds, Gs^Fds, Gs^Fds, Gs^Fds, Ww, Ww, Ww, Ww, Wo, Wo, Wo, Wo, Wo, Wo
Gs^Fds, Gs^Fds, Gs^Fds, Gs^Fms, Mm^Xm, Hh^Fds, Mm, Hh^Fms, Hh, Hh^Fds, Hh^Fds, Hh^Fds, Hh^Fds, Hh^Fms, Hh^Fds, Mm, Mm, Mm, Mm, Mm, Mm, Wog, Wog, Mm^Xm, Mm, Mm, Mm, Mm, Hh^Fds, Hh, Hh^Fds, Hh^Fds, Hh^Fp, Hh, Hh, Hh^Fds, Hh^Fms, Hh^Fms, Gs^Fms, Gs^Efm, Gg^Efm, Gg^Efm, Gg, Gs^Fds, Gg, Gg^Vct, Gs^Fms, Ce, Ce, 2 Ke, Ce, Gs^Fds, Ww, Ww, Ww, Ww, Wo, Wo, Wo, Wo, Wo, Wo
Gs^Fms, Gs^Fds, Gs^Fds, Mm, Mm, Mm^Xm, Mm^Xm, Ww, Ww, Ww, Ww, Hh^Fds, Hh^Fds, Hh, Hh^Fds, Hh^Fds, Hh, Mm, Hh, Mm, Mm, Wog, Wog, Mm, Mm, Mm, Hh^Fp, Hh^Fds, Hh^Fds, Hh, Hh^Fds, Hh^Fms, Hh^Fms, Hh^Fms, Hh, Hh, Hh^Fds, Hh^Fds, Gg, Gg^Efm, Gs^Efm, Gs^Efm, Gs, Gs, Gg, Gs^Fds, Gs^Fds, Gs^Fds, Gg^Ecf, Ce, Ce, Ce, Ww, Ww, Ww, Wo, Wo, Wo, Wo, Wo, Wo, Wo
Gs^Fms, Gs^Fms, Gs^Fds, Mm, Gs^Fds, Mm, Mm, Mm, Mm, Hh^Fms, Hh^Fds, Ww, Ww, Gs^Em, Gs^Em, Hh, Hh, Hh^Fds, Hh, Hh^Fms, Hh, Mm, Ww, Mm, Hh^Fds, Hh^Fds, Hh, Hh^Fds, Hh^Fds, Hh, Hh^Fds, Hh^Fms, Hh^Fds, Hh^Fds, Hh, Hh, Hh, Hh, Gg^Efm, Gg^Efm, Gg^Efm, Gg^Efm, Gg, Gg, Gs^Fds, Gs^Fds, Gs^Fds, Gs^Fds, Gg, Gg, Gs^Fds, Gs^Fms, Ds, Ww, Ww, Wo, Wo, Wo, Wo, Wo, Wo, Wo
Gg^Efm, Gs^Fds, Gs^Fds, Gs^Fds, Gg, Gs^Fms, Gs^Fms, Mm, Hh^Fds, Hh, Hh^Fds, Hh^Fds, Wwf, Gs^Em, Gs^Tf, Gs^Em, Hh^Fds, Hh^Fds, Hh^Fds, Hh^Fds, Hh^Fms, Hh^Fds, Hh^Fds, Ww, Hh^Fds, Hh^Fds, Hh, Hh^Fds, Hh^Fms, Hh^Fds, Hh^Fms, Hh^Fms, Hh^Fds, Hh^Fds, Hh^Fds, Hh^Fms, Hh^Fp, Gs^Fds, Gs^Fds, Gg^Efm, Gs^Fds, Gg^Vct, Gs^Fds, Gs^Fds, Gs^Fds, Gs^Vct, Gs^Fds, Gg, Gs^Fms, Gs^Vct, Gs^Fds, Gs^Fms, Ds, Ww, Ww, Wo, Wo, Wo, Wo, Wo, Wo, Wo
Gg^Efm, Gg^Efm, Gs^Fds, Gs^Fds, Gs^Fds, Gg, Gs^Fms, Gs^Fds, Gll^Fp, Hh^Fms, Hh, Hh^Fms, Wwf, Hh^Tf, Hh^Tf, Hh^Tf, Hh^Fds, Hh^Fds, Hh^Fds, Hh^Fds, Ss, Ss, Ss, Ww, Ww, Hh^Fds, Hh, Hh^Fds, Hh^Fds, Hh^Fds, Hh^Fds, Hh^Fds, Hh^Fds, Hh^Fms, Hh^Fds, Hh^Fds, Gs^Fds, Gs^Fds, Gg, Gg, Gg, Gs^Fds, Gs^Fms, Gs^Fds, Gs^Fds, Gs^Fms, Gg, Gg, Gg, Gs^Fds, Ds, Ds, Ww, Ww, Ww, Wo, Wo, Wo, Wo, Wo, Wo, Wo
Gs^Fms, Gg^Efm, Gs^Fms, Gs^Fms, Gs^Fds, Gs^Fds, Gg^Efm, Gs^Fds, Gs^Fms, Hh^Fds, Hh^Fds, Hh^Fds, Ww, Hh^Tf, Hh^Em, Hh^Fms, Wwf, Hh^Fds, Wwf, Ss, Hh^Fms, Hh^Fms, Hh, Hh, Hh^Fds, Ww, Hh^Fds, Hh^Fds, Hh^Fp, Hh^Fms, Hh^Fds, Hh^Fds, Hh^Fds, Hh^Fms, Hh^Fms, Gs^Fds, Gs^Fds, Gs^Fms, Gg, Gs^Fms, Gs^Fds, Gs^Fds, Gs^Fds, Gs^Fds, Gs^Fds, Gs^Fms, Gs^Fds, Gg, Gs^Fds, Gs^Fms, Ww^Ewl, Ww, Ww, Ww, Wo, Wo, Wo, Wo, Wo, Wo, Wo, Wo
Gs^Fds, Gg^Efm, Gs^Fms, Gs^Fds, Gs^Fms, Gs^Fds, Gs^Fms, Gg^Efm, Gg^Efm, Gs^Fds, Gg^Em, Hh^Em, Hh^Em, Ww, Wwf, Wwf, Hh^Fds, Ss, Ss, Ss, Ss, Ss, Hh, Hh^Fds, Hh, Ww, Ww, Gg, Gg, Hh^Fp, Hh^Fms, Hh^Fds, Hh^Fp, Hh^Fms, Gg^Emf, Gs^Fds, Gg^Em, Gs^Fms, Wwf, Gg, Gll^Fp, Gs^Fds, Ss, Gs^Fds, Wwf, Gs^Fds, Gs^Fds, Gs^Fds, Ww, Ww, Ww, Ww, Ww, Ww, Ww, Wo, Wo, Wo, Wo, Wo, Wo, Wo
Gs^Fds, Gs^Fms, Gs^Fds, Gs^Fds, Gs^Fms, Gs^Fds, Gs, Gs^Fds, Gs^Fms, Gs^Fms, Gs^Fds, Gs^Fds, Gg^Em, Hh^Fds, Hh^Fds, Hh^Fds, Hh^Fds, Hh^Fds, Hh^Fds, Hh, Ss, Wwf, Ss, Hh, Ss, Ww, Ww, Ww, Gg, Gg, Hh^Fds, Hh, Ww, Gg^Em, Ww^Ewl, Gg^Vct, Ww, Ww, Wwf, Ww^Bw|r, Ss^Tf, Ss, Ss, Ss, Wwf, Wwf, Ww, Ww, Gs^Fds, Ww^Ewf, Ds, Ww, Ww, Ww, Ww, Wo, Wo, Wo, Wo, Wo, Wo, Wo
Gs^Fds, Gs^Fds, Gs, Gs, Gs^Fds, Gs, Gs^Fds, Gs^Fms, Gg^Efm, Gs^Fms, Gg^Efm, Gs^Fds, Gs^Fds, Gs^Fds, Gg, Hh^Vct, Re, Hh^Fds, Hh^Fds, Hh^Fds, Hh^Fds, Ss, Hh^Fds, Ss, Ss, Ww^Ewf, Ww, Ww, Ww, Ww, Ww, Ww, Gg, Ww, Ww, Ww, Ss, Ss, Ss, Wwf^Bw|r, Ww, Ww, Ww, Ww, Gs^Fds, Gs^Fds, Gs^Fds, Gs^Fds, Gs^Fms, Gll^Fp, Gs^Fms, Ds, Ds, Ww, Ww, Wo, Wo, Wo, Wo, Wo, Wo, Wo
Gs^Fds, Gs^Fms, Gs^Fds, Gs, Gs, Gs, Gg, Gs^Fds, Gg, Gg^Efm, Gg^Efm, Gg^Efm, Gs^Efm, Gg^Efm, Gs^Efm, Re, Mm, Re, Re, Hh, Hh^Fds, Hh^Fds, Hh^Fds, Hh^Fms, Hh^Fds, Gg, Gg^Tf, Ww, Gg, Gg, Hh, Hh, Gs^Fds, Gs^Fds, Gs^Fms, Ss, Gs^Fds, Gs^Fds, Gg^Efm, Gg, Gg^Vct, Gs^Fds, Gs^Fds, Ww, Gs^Fds, Gs^Fms, Gs^Fds, Gs^Fds, Gs^Fds, Gs^Fds, Gs^Fds, Gs^Fms, Ds, Ww, Ww, Wo, Wo, Wo, Wo, Wo, Wo, Wo
Gs^Fds, Gs^Fds, Gs^Fms, Gs^Fds, Gs^Fds, Gg, Gs^Vct, Gg, Gs^Fds, Gg, Gs^Fds, Gs, Gs, Gs, Hh^Fds, Mm, Hh, Mm, Re, Hh^Vct, Hh^Fds, Hh^Fds, Hh^Fds, Hh^Fds, Hh^Fms, Hh^Fds, Ww, Ww, Hh^Fms, Hh^Fms, Hh^Fds, Hh^Fds, Gs^Fds, Gs^Fds, Ss^Fds, Gs^Fds, Gs^Fms, Gll^Efm, Gg^Efm, Gs^Fds, Gs^Fds, Gg, Gs^Fds, Gs^Fds, Gg, Gs^Fds, Gs^Fds, Gs^Fms, Gs^Fms, Gs^Fds, Gs^Fms, Ds, Ww, Ww, Ww, Wo, Wo, Wo, Wo, Wo, Wo, Wo
Gs^Fds, Gs^Fds, Gs^Fds, Gs^Vct, Gs^Fds, Gs^Fds, Gs^Fms, Gs^Fms, Gs^Fms, Gs^Fds, Gs^Fds, Gs^Fds, Hh^Fds, Hh^Fms, Mm, Mm, Hh^Fds, Hh^Fms, Re, Hh^Fms, Hh^Fds, Hh^Fds, Mm, Mm, Mm, Mm, Mm, Hh^Fds, Hh^Fds, Chr, Re, Ss^Fms, Re, Re, Re, Ss^Fms, Re, Re, Gs^Fms, Gg^Efm, Gs^Efm, Gg, Gs^Fds, Gs^Fds, Hh^Fds, Gs^Fds, Gll^Fp, Gll^Fp, Gs^Fds, Gs^Fds, Gs^Fds, Ds, Ww, Ww, Wo, Wo, Wo, Wo, Wo, Wo, Wo, Wo
Gs^Fds, Gs^Fds, Gs^Fds, Gs^Fds, Ce, Gs^Fds, Gs^Fms, Gs^Fds, Gs^Fms, Gs^Vct, Gs^Fds, Gs^Fds, Hh^Fds, Mm, Mm, Hh, Gs^Fms, Hh^Fms, Ww, Re, Ss^Bw\r, Mm, Mm, Mm, Hh^Fms, Mm, Mm, Mm, Re, Re, Mm, Re, Ss^Fds, Ss^Fds, Ss^Fds, Re, Gs^Vct, Gg^Efm, Gg^Efm, Gg^Efm, Gg^Efm, Gg^Efm, Hh, Hh^Fds, Hh^Fds, Hh^Fds, Hh^Fms, Gs^Fds, Gs^Fds, Gs^Fds, Gs^Fds, Ww, Ww, Ww, Wo, Wo, Wo, Wo, Wo, Wo, Wo, Wo
Gs^Fds, Gs^Fms, Gs^Fds, Ce, 3 Ke, Ce, Gs^Fms, Gs^Fds, Gs^Fms, Gs^Fds, Gs^Fds, Gs^Fds, Gd, Mm, Mm, Hh^Vct, Gs, Gs^Fms, Gs^Fds, Ss, Mm, Re, Re, Hh^Fms, Hh^Vct, Hh, Hh, Re, Mm, Mm, Mm, Gs^Fds, Sm^Fms, Gs^Fds, Gs^Fms, Gs^Fds, Gs^Fds, Gs^Fds, Gg, Gg^Efm, Gs^Fms, Hh, Mm, Mm^Xm, Mm, Hh^Fds, Hh^Fds, Hh^Fds, Gs^Fds, Gs^Fds, Gs^Fds, Ww, Ww, Ww, Wo, Wo, Wo, Wo, Wo, Wo, Wo, Wo
Gs^Fds, Gs^Vct, Ww, Ce, Gs^Fds, Gs^Ecf, Ww, Gs^Vct, Ww, Ds, Ds, Ds, Gd^Fdw, Gd, Gs^Fds, Gs^Fds, Gs^Fds, Gs^Fms, Gs^Fds, Gs^Fds, Mm, Mm, Hh, Hh, Ds, Ds, Ds, Hh, Hh^Vct, Mm, Mm, Mm, Sm^Fds, Sm^Fms, Gs^Fms, Gs^Fds, Gg, Gg, Gs^Fds, Gg, Hh^Fms, Hh, Mm, Mm, Mm^Xm, Mm^Xm, Mm, Hh^Fds, Gs^Fms, Gs^Fds, Gs^Fds, Ww, Ww, Ww, Ww, Wo, Wo, Wo, Wo, Wo, Wo, Wo
Ww, Ww, Ww, Ww, Ww, Ww, Ww, Ww, Ww, Ww, Ww, Ds, Ds, Ds, Gs^Fms, Gll^Fp, Gs^Fds, Gs^Fds, Gs^Fms, Gll^Fp, Mm, Mm, Ds, Ds, Wwf, Wwf, Wwf, Ds, Hh, Mm, Mm, Mm, Sm^Fds, Sm^Fds, Gs^Fds, Gs^Fds, Gg, Gg, Gg, Gs^Fds, Hh^Fms, Hh^Fds, Mm, Mm^Xm, Mm, Mm, Mm, Hh^Fds, Gs^Fds, Gs^Fms, Gs^Fds, Ds, Ds, Ww, Ww, Wo, Wo, Wo, Wo, Wo, Wo, Wo
Ww, Ww, Ww, Ww, Ww, Ww, Ww, Ww, Ww, Ww, Ds, Ds, Gs^Fds, Gs^Fms, Gs^Fds, Gs^Fds, Gs^Fms, Gs^Fms, Mm, Mm, Mm, Mm, Wwf, Wwf, Wwg, Wwg, Wwg, Wwf, Hh, Hh^Fp, Mm, Mm, Gs^Fds, Sm^Fms, Gs^Fds, Gs^Fms, Gg, Gs^Fds, Gs^Fms, Gg, Gs^Fds, Hh^Fms, Hh^Fms, Mm, Mm, Mm, Hh^Fds, Hh^Fds, Gs^Fds, Gs^Fds, Gs^Fds, Gs^Fds, Ds, Ww, Ww, Wo, Wo, Wo, Wo, Wo, Wo, Wo
Wo, Ww, Wo, Ww, Ww, Ww, Ww, Ww, Wo, Wo, Ww, Gs^Fms, Gs^Fds, Gs^Fms, Gs^Fms, Gs^Fds, Gs^Fds, Ds, Ds, Mm, Hh, Hh^Tf, Wwg, Wwg, Wwg, Wwg, Wwg, Ww, Hh^Fms, Hh^Fms, Mm, Mm, Gs^Fds, Gs^Fms, Gs^Fds, Gs^Fds, Gs^Fms, Gg, Gg, Gg, Gs^Fds, Hh^Fds, Gs^Fms, Hh^Fds, Hh^Fds, Hh^Fds, Gs^Fds, Gs^Fds, Gs^Fds, Gs^Fms, Gs^Fms, Ds, Ww, Ww, Ww, Wo, Wo, Wo, Wo, Wo, Wo, Wo
Wo, Wo, Wo, Wo, Wo, Wo, Wo, Wo, Wo, Ww, Ww, Gs^Fds, Gs^Fds, Gs^Fms, Gs^Fds, Gs^Fds, Ww^Ewf, Ds, Ww, Mm, Hh, Chr, Ww, Wwg, Ds^Vct, Ds, Ds, Chw, Mm, Mm, Mm, Mm, Gs^Fds, Gs^Fds, Gs^Fds, Gs^Fds, Gg, Gg, Gs^Fds, Gs^Fms, Gs^Fms, Gs^Fds, Gs^Fds, Gll^Fp, Gs^Fms, Gs^Fms, Gs^Fds, Gs^Fds, Gs^Fms, Gs^Fds, Gs^Fds, Ww, Ww, Ww, Wo, Wo, Wo, Wo, Wo, Wo, Wo, Wo
Wo, Wo, Wo, Wo, Wo, Wo, Wo, Wo, Wo, Ww, Ww, Gs^Fds, Gs^Fds, Gs^Fds, Ww, Ww, Ww, Ww, Ww, Ww, Ww, Ww, Ww, Hh, Hh, Mm, Mm, Mm, Mm, Mm, Gs^Fds, Gs^Fds, Gs^Fms, Gs^Fds, Gg^Tf, Gs^Tf, Gs, Gg, Gg^Es, Gs^Fms, Gs^Fds, Gs^Fds, Gs^Fds, Gs^Fds, Gs^Fms, Gs^Fds, Gs^Fds, Gs^Fms, Gs^Fms, Gs^Fds, Ww, Ww, Ww, Ww, Wo, Wo, Wo, Wo, Wo, Wo, Wo, Wo
Wo, Wo, Wo, Wo, Wo, Wo, Wo, Wo, Wo, Ww, Ww, Ww, Ww, Ww, Wo, Wo, Wo, Wo, Wo, Wo, Ww, Ww, Ww, Hh, Hh, Mm, Mm, Mm, Gs^Fds, Gs^Fds, Gs^Fds, Gs^Fds, Gs^Fms, Gs^Tf, Gg^Tf, Gg, Gs^Fds, Gs^Fds, Gs^Fds, Gs^Fds, Gs^Fds, Gs^Fds, Ds^Es, Ds^Es, Ds^Es, Ds, Ds, Gs^Fds, Gs^Fds, Gs^Fds, Ww, Ww, Ww, Wo, Wo, Wo, Wo, Wo, Wo, Wo, Wo, Wo
Wo, Wo, Wo, Wo, Wo, Wo, Wo, Wo, Wo, Wo, Wo, Wo, 1 Wo, Wo, Wo, Wo, Wo, Wo, Ww, Ww, Ww, Ww, Gs^Fds, Gs^Fms, Gs^Fds, Gs^Fds, Gs^Fms, Gs^Fds, Gs^Fds, Gs^Fds, Gs^Fms, Gll^Fp, Gll^Fp, Gg^Tf, Gg, Gg, Gs^Fms, Gs^Fds, Gs^Fds, Gll^Fp, Gs^Fds, Ds^Es, Ds, Ds^Es, Ds, Ds, Ww, Ww, Ww, Ww, Ww, Ww, Ww, Wo, Wo, Wo, Wo, Wo, Wo, Wo, Wo, Wo
Wo, Wo, Wo, Wo, Wo, Wo, Wo, Wo, Wo, Wo, Wo, Wo, Ww, Ww, Ww, Ww, Ww, Ww, Ww, Ww, Ww, Ww, Gs^Fds, Gs^Fds, Gs^Fds, Gs^Fds, Gs^Fms, Gs^Fds, Gs^Fms, Gs^Fms, Gg, Gs^Fds, Gg, Gg, Gs^Fds, Gs^Fds, Gs^Fds, Gs^Fds, Gs^Fds, Gs^Fds, Ds, Ds, Ds, Ww, Ww, Ww, Ww, Ww, Ww, Ww, Ww, Ww, Wo, Wo, Wo, Wo, Wo, Wo, Wo, Wo, Wo, Wo
Wo, Wo, Wo, Wo, Wo, Wo, Wo, Wo, Wo, Wo, Ww, Ww, Ww, Ww, Ww, Ww, Gs^Fms, Ww, Gs^Fds, Ww, Gs^Fds, Gs^Fms, Gs^Fds, Gll^Fp, Gs^Fms, Gs^Fms, Gs^Fds, Gs^Fds, Gg, Gg, Gs^Fms, Gg, Gs^Fds, Gs^Fds, Gs^Fds, Gll^Fp, Gs^Fds, Gs^Fms, Gs^Fms, Ds, Ds, Ds, Ww, Ww, Wo, Ww, Ww, Ww, Ww, Ww, Wo, Wo, Wo, Wo, Wo, Wo, Wo, Wo, Wo, Wo, Wo, Wo
Wo, Wo, Wo, Wo, Ds, Wo, Wo, Wo, Ww, Ww, Ww, Ww, Gs^Fms, Gs^Fms, Gs^Fds, Gs^Fms, Gs^Fds, Gs^Fds, Gs^Fds, Gs^Fds, Gs^Fms, Gs^Fms, Gs^Fds, Gs^Fds, Gg^Efm, Gs^Fds, Gg, Gg, Gg, Gs^Fds, Gll^Fp, Gs^Fms, Gs^Fds, Gs^Fds, Gs^Fds, Gs^Fds, Gs^Fds, Gs^Fds, Gs^Fms, Ww, Ww, Ww, Ww, Wo, Wo, Wo, Wo, Wo, Wo, Wo, Wo, Wo, Ds^Fdw, Ds, Gd^Fdw, Wo, Wo, Wo, Wo, Wo, Wo, Wo
Wo, Gd, Gd^Fdw, Ds^Fdw, Wo, Wo, Wo, Wo, Ww, Ww, Ww, Ww, Gs^Fds, Gs^Fds, Gs^Fds, Gs^Fds, Gs^Fds, Gs^Fms, Gs^Fds, Gs^Fds, Gs^Fms, Gg^Efm, Gg^Efm, Gg^Efm, Gg^Efm, Gg, Gs^Fms, Gg, Gs^Fds, Gs^Fms, Gs^Fds, Gs^Fms, Gs^Fms, Gs^Fds, Gs^Fds, Gs^Fds, Gs^Fds, Gs^Fds, Gs^Fms, Ww, Ww, Ww, Wo, Wo, Wo, Wo, Wo, Wo, Wo, Wo, Wo, Wo, Wo, Gd^Fdw, Gd^Fdw, Ds^Fdw, Ds, Wo, Wo, Wo, Wo, Wo
Wo, Gd^Fdw, Ds, Ds^Fdw, Ds, Wo, Wo, Wo, Wo, Ww, Ww, Ww, Gs^Fds, Gs^Fms, Gs^Fds, Gs^Fds, Gs^Fds, Gs^Fds, Gs^Fms, Gs^Fds, Gs^Fms, Gg^Efm, Gs, Gs^Efm, Gg, Gg, Gs^Fds, Gs^Fds, Gs^Fds, Gs^Fds, Gs^Fds, Gs^Fds, Gs^Fds, Gs^Fds, Gs^Fds, Gs^Fms, Gs^Fds, Gs^Fds, Gll^Fp, Ww, Ww, Ww, Wo, Wo, Wo, Wo, Wo, Wo, Wo, Wo, Wo, Wo, Ds, Ds, Wo, Wo, Wo, Wo, Wo, Wo, Wo, Wo
Wo, Wo, Wo, Wo, Wo, Wo, Wo, Wo, Wo, Wo, Ww, Ww, Ww, Gs^Fds, Ww, Gs^Fds, Gs^Fds, Gs^Fds, Gs^Fds, Gs^Fms, Gs^Fds, Gs^Fds, Gs^Fds, Gs, Gs^Fds, Gg, Gg, Gs^Fds, Ss, Ss, Wwf, Wwf, Ss, Wwf, Wwf, Ss, Ss, Gs^Fds, Gs^Fds, Ww, Ww, Ww, Wo, Wo, Wo, Wo, Wo, Wo, Wo, Wo, Wo, Wo, Wo, Wo, Wo, Wo, Wo, Wo, Wo, Wo, Wo, Wo
Wo, Wo, Wo, Wo, Wo, Wo, Wo, Wo, Wo, Wo, Wo, Ww, Ww, Ww, Ww, Gs^Fds, Gs^Fms, Gs^Fds, Gs^Fds, Gs^Fms, Gs^Fds, Gs^Fms, Gs^Fds, Gs^Fds, Gs^Fds, Gg, Gg, Gg, Wwf^Ewl, Wwf, Wwf, Ww, Ss, Ss, Wwf, Wwf, Ss, Gs^Fms, Wwf, Wwf, Ww, Ww, Wo, Wo, Wo, Wo, Wo, Wo, Wo, Wo, Wo, Wo, Wo, Wo, Wo, Wo, Wo, Wo, Wo, Wo, Wo, Wo
Wo, Wo, Wo, Wo, Wo, Wo, Wo, Wo, Wo, Wo, Wo, Wo, Ww, Ww, Ww, Ww, Ww, Gs^Fds, Gs^Fds, Gs^Fds, Ww, Gs^Fms, Gs^Fds, Gs^Fms, Gs^Fds, Gs^Fds, Ss, Ss, Wwf, Wwf, Wwf, Ww, Wwf, Wwf, Gs^Fds, Wwf, Wwf, Wwf, Gs^Fds, Ds, Ds, Ww, Wo, Wo, Wo, Wo, Wo, Wo, Wo, Wo, Wo, Wo, Wo, Wo, Wo, Wo, Wo, Wo, Wo, Wo, Wo, Wo
Wo, Wo, Wo, Wo, Wo, Wo, Wo, Wo, Wo, Wo, Wo, Wo, Wo, Ww, Ww, Ww, Ww, Ww, Ww, Ww, Ww, Ww, Ww, Gs^Fds, Gs^Fds, Gs^Fds, Wwf, Ss, Gs^Fds, Ss, Ss, Wwf, Gg, Gs^Fms, Gs^Fms, Gs^Fms, Gs^Fms, Gs^Fds, Gs^Fms, Ds, Ds, Ww, Wo, Wo, Wo, Wo, Wo, Wo, Wo, Wo, Wo, Wo, Wo, Wo, Wo, Wo, Wo, Wo, Wo, Wo, Wo, Wo
Wo, Wo, Wo, Wo, Wo, Wo, Wo, Wo, Wo, Wo, Wo, Wo, Wo, Wo, Ww, Ww, Ww, Ww, Ww, Ww, Ww, Ww, Ww, Wwf, Wwf, Wwf, Gs^Fds, Gs^Fds, Gs^Fds, Gs^Fds, Gs^Fds, Gs^Fms, Gg^Efm, Gs^Fds, Gg^Efm, Gs^Fds, Gs^Fds, Gs^Fms, Gs^Fms, Ds^Es, Ds, Ww, Wo, Wo, Wo, Wo, Ww, Wo, Wo, Wo, Wo, Wo, Wo, Wo, Wo, Wo, Wo, Wo, Wo, Wo, Wo, Wo
Wo, Wo, Wo, Wo, Wo, Wo, Wo, Wo, Wo, Wo, Wo, Wo, Wo, Wo, Wo, Ww, Ww, Ww, Ww, Ww, Ww, Ww, Ww, Wwf, Gs^Fds, Gs^Fds, Gs^Fms, Gs^Fms, Gs, Gg, Gs^Fms, Gg^Efm, Gg^Efm, Gg^Efm, Gg^Efm, Gg^Efm, Gs^Fds, Gs^Fds, Gs^Fds, Ds^Es, Ds^Es, Ds^Es, Ww, Ww, Ww, Ww, Ww, Ww, Ww, Wo, Wo, Wo, Wo, Wo, Wo, Wo, Wo, Wo, Wo, Wo, Wo, Wo
Wo, Wo, Wo, Wo, Wo, Wo, Wo, Wo, Ds, Wo, Wo, Wo, Wo, Wo, Wo, Wo, Wo, Ww, Wo, Wo, Wo, Ww, Ww, Ww, Gs^Fms, Gs^Fds, Gs^Fds, Gg, Gg, Gg, Gs^Fms, Gs^Fds, Gs^Fds, Gs^Fds, Gg^Efm, Gs^Fms, Gs^Fds, Gs^Fms, Gs^Fds, Gs^Fds, Gs^Fds, Ds, Ds, Ww, Ww, Ww, Ww, Ww, Ww, Wo, Wo, Wo, Wo, Wo, Wo, Wo, Wo, Wo, Wo, Wo, Wo, Wo
Wo, Wo, Wo, Wo, Wo, Ds, Gd^Fdw, Ds^Fdw, Gd^Fdw, Ds, Wo, Wo, Wo, Wo, Wo, Wo, Wo, Wo, Wo, Wo, Ww, Ww, Ww, Ww, Gs^Fds, Gs^Fds, Gs^Fds, Gs^Fds, Gs^Fds, Gs^Fds, Gs^Fds, Gs^Fds, Gs^Fms, Gg^Efm, Gs^Efm, Gs, Gg, Gs, Gg, Gs^Fds, Gs^Fds, Gs^Fds, Gs^Fms, Ds, Ds, Ww, Ww, Ww, Ww, Wo, Wo, Wo, Wo, Wo, Wo, Wo, Wo, Wo, Wo, Wo, Wo, Wo
Wo, Wo, Wo, Wo, Wo, Ds, Gd, Wo, Wo, Wo, Wo, Wo, Wo, Wo, Wo, Wo, Wo, Wo, Wo, Wo, Ww, Ww, Gs^Fds, Gs^Fms, Gs^Fds, Gs^Fds, Gs^Fds, Gs^Fds, Ds, Gs^Fms, Gs^Fds, Gs^Fds, Gs^Fms, Gg, Gs^Fms, Gs^Fms, Gs^Fds, Gg, Gs, Gs^Fds, Gg, Gs^Fds, Gs^Fds, Gs^Fds, Gs^Fds, Ww, Ww, Ww, Ww, Wo, Wo, Wo, Wo, Wo, Wo, Wo, Wo, Wo, Wo, Wo, Wo, Wo
Wo, Wo, Wo, Wo, Wo, Wo, Wo, Wo, Wo, Wo, Wo, Wo, Wo, Wo, Wo, Wo, Wo, Wo, Ww, Ww, Gs^Fds, Gs^Fds, Gs^Fds, Gs^Fms, Gs^Fms, Gs^Fds, Ds, Ds, Ds, Ds, Ds, Gs^Fms, Gs^Fds, Gs^Fds, Gs^Fds, Gs^Fds, Gs^Fds, Gs^Fds, Gs^Fds, Gs, Gg^Efm, Gs^Fds, Gg, Gs^Fds, Gs^Fds, Ww, Ww, Ww, Wo, Wo, Wo, Wo, Wo, Wo, Wo, Wo, Wo, Wo, Wo, Wo, Wo, Wo
Wo, Wo, Wo, Wo, Wo, Wo, Wo, Wo, Wo, Wo, Wo, Wo, Wo, Wo, Wo, Wo, Ww, Ww, Ww, Ww, Gs^Fds, Gs^Fds, Gs^Fms, Gs^Fds, Gs^Fds, Ww, Ww, Ds, Ww, Ds, Ww, Ww, Gs^Fds, Gs^Fms, Gs^Fms, Gs^Fds, Gs^Fms, Gs^Fds, Gs^Fds, Gg^Efm, Gg, Gg^Efm, Gg^Efm, Gll^Fp, Gs^Fds, Ww, Ww, Ww, Wo, Wo, Wo, Wo, Wo, Wo, Wo, Wo, Wo, Wo, Wo, Wo, Wo, Wo
Wo, Wo, Wo, Wo, Wo, Wo, Wo, Wo, Wo, Wo, Wo, Wo, Wo, Wo, Wo, Ww, Ww, Ww, Ww, Ww, Gs^Fds, Gs^Fds, Gs^Fds, Gs^Fds, Ww, Ww, Ww, Ww, Ww, Ww, Ww, Ww, Ww, Gs^Fds, Gs^Fms, Gs^Fds, Gs^Fds, Gs^Fds, Gs^Fms, Gs^Fds, Gs^Fds, Gs^Fms, Gs^Fds, Gs^Fds, Gs^Fms, Ww, Ww, Ww, Wo, Wo, Wo, Wo, Wo, Wo, Wo, Wo, Wo, Wo, Wo, Wo, Wo, Wo
Wo, Wo, Wo, Wo, Wo, Wo, Wo, Wo, Wo, Wo, Wo, Wo, Wo, Wo, Wwr, Ww, Ww, Ww, Ww, Ww, Ww, Gs^Fds, Ww, Ww, Ww, Ww, Wo, Ww, Wo, Ww, Ww, Ww, Ww, Ww, Ww, Gs^Fds, Gs^Fds, Gs^Fms, Gs^Fms, Gs^Fds, Gs^Fds, Gs^Fms, Gs^Fds, Gs^Fds, Gs^Fds, Ww, Ww, Wo, Wo, Wo, Wo, Wo, Wo, Wo, Ds, Ds, Ds^Esd, Ds, Ds, Wo, Wwr, Wo
Wo, Wo, Wo, Wo, Wo, Wo, Wo, Wo, Wo, Wo, Wo, Wo, Wo, Wo, Wwr, Wwr, Wwr, Ww, Ww, Ww, Ww, Ww, Ww, Ww, Wo, Wo, Wo, Wo, Wo, Wo, Wo, Ww, Ww, Ww, Ww, Ww, Ww, Ww, Ww, Ww, Ww, Gs^Fms, Ww, Gs^Fds, Ww, Ww, Wo, Wo, Wo, Wo, Wo, Wo, Wo, Wo, Ds, Ds^Esd, Gd^Fdw, Ds^Esd, Ds^Fdw, Wwr, Wwr, Wwr
Wo, Wo, Wo, Wo, Wo, Wo, Wo, Wo, Wo, Wo, Wo, Wo, Wwr, Wwr, Wwr, Wwr, Wwr, Wwr, Wwr, Ww, Ww, Ww, Wo, Wo, Wo, Wo, Wo, Wo, Wo, Wo, Wo, Wo, Ww, Ww, Ww, Ww, Ww, Ww, Ww, Ww, Ww, Ww, Ww, Ww, Ww, Ww, Wwr, Wo, Wo, Wo, Wo, Wo, Wwr, Wo, Wwr, Wwr, Wwr, Ds^Fdw, Wwr, Wwr, Wwr, Wwr
Wo, Wo, Wo, Wo, Wo, Wo, Wo, Wo, Wo, Wo, Wo, Wo, Wo, Wwr, Wo, Wo, Wo, Wo, Wo, Wwr, Wwr, Wwr, Wwr, Wwr, Wo, Wo, Wo, Wo, Wo, Wo, Wo, Wo, Wwr, Wwr, Wwr, Wwr, Wwr, Wwr, Wwr, Wwr, Wwr, Wwr, Wwr, Wwr, Wwr, Wwr, Wwr, Wwr, Wo, Wo, Wo, Wo, Wwr, Wwr, Wwr, Wwr, Wwr, Wwr, Wwr, Wwr, Wwr, Wwr
