Wo, Wo, Wo, Wo, Wo, Wo, Wo, Wo, Wo, Wo, Wo, Wo, Wo, Wo, Wo, Wo, Wo, Wo, Wo, Wo, Wo, Wo, Wo, Wo, Wo, Wo, Wo, Wo, Wo, Wo, Wo, Wo, Wo, Wo, Wo, Wo, Wo, Wo
Wo, Wo, Wo, Wo, Wo, Wo, Wo, Wo, Wo, Wo, Wo, Wo, Wo, Wo, Wo, Wo, Ds, Ds, Ds, Ds, Ds, Ds, Ds, Ds, Ds, Wo, Wo, Wo, Wo, Wo, Wo, Wo, Wo, Wo, Wo, Wo, Wo, Wo
Wo, Wo, Wo, Wo, Wo, Wo, Wo, Wo, Wo, Wo, Ds, Ds, Ds, Ds, Ds, Ds, Mm^Vu, Mm^Fet, Mm, Mm, Mm^Fet, Mm^Fp, Mm^Vu, Mm^Fet, Mm^Fp, Ds, Ds, Wo, Wo, Wo, Wo, Wo, Wo, Wo, Wo, Wo, Wo, Wo
Wo, Wo, Wo, Wo, Wo, Wo, Wo, Wo, Ds, Ds, Hh^Fp, Mm^Fet, Mm, Mm^Fet, Mm, Mm, Mm^Fp, Mm^Fp, Mm^Fp, Mm, Mm^Fp, Mm^Fp, Mm^Fet, Mm^Fp, Mm^Fp, Mm^Fet, Hh^Fp, Ds, Ds, Wo, Ds, Wo, Wo, Wo, Wo, Wo, Wo, Wo
Wo, Wo, Wo, Wo, Wo, Wo, Wo, Ds, Hh^Fp, Hh^Fp, Hh^Fp, Mm^Fp, Mm^Vu, Mm^Fp, Mm^Fp, Mm^Fet, Mm^Fp, Mm^Fp, Mm^Fet, Mm^Fp, Mm, Mm^Fp, Mm^Fp, Mm^Fp, Mm^Fp, Mm^Fp, Hh^Fp, Hh^Fp, Ds, Ds, Gg^Fp, Ds, Ds, Wo, Wo, Wo, Wo, Wo
Wo, Wo, Wo, Wo, Wo, Wo, Ds, Ds, Ds, Hh^Fp, Hh^Fp, Mm^Fet, Mm^Fp, Mm^Fet, Mm^Fp, Mm^Fp, 2 Kvr, Mm^Fp, Mm, Mm^Fp, Mm^Fet, Mm^Fp, Mm^Fp, Mm^Fet, Mm^Fp, Mm^Vu, Hh^Fp, Hh^Fp, Gg^Fp, Gg^Fp, Gg^Fp, Gg^Fp, Gg^Fp, Ds, Ds, Wo, Wo, Wo
Wo, Wo, Wo, Wo, Ds, Ds, Gg^Fp, Ds, Hh^Fp, Hh^Fp, Hh^Fp, Hh^Fp, Hh^Fp, Hh^Fp, Hh^Fp, Cvr, Mm^Fet, Cvr, Cvr, Mm^Fp, Mm^Fp, Mm, Mm^Fp, Mm, Mm, Mm^Fet, Hh, Hh^Fp, Hh^Fmw, Hh^Fp, Hh^Fmw, Gg^Fp, Gg^Fp, Gg^Fp, Gg^Fp, Ds, Ds, Wo
Wo, Wo, Ds, Ds, Gg^Fp, Gg^Fp, Gg^Fms, Gg^Fms, Gg^Fdw, Hh^Fp, Hh^Fp, Hh^Fp, Hh^Fp, Hh^Fp, Hh^Fp, Mm, Hh^Fp, Mm^Fp, Hh^Fp, Mm^Vu, Hh^Fp, Mm^Fp, Hh^Fp, Mm, Hh^Fp, Hh^Fp, Hh^Fp, Hh^Fmw, Hh^Fms, Hh^Fmw, Hh^Fmw, Gg^Fmw, Gg^Fp, Gg^Fp, Gg^Fp, Ds, Gg^Fp, Ds
Wo, Wo, Ds, Ds, Hh^Fp, Hh^Fms, Hh^Fdw, Gg^Fdw, Gg^Fms, Gg^Fms, Hh^Fp, Hh^Fdw, Hh^Fdw, Hh^Fp, Hh^Fp, Hh^Fp, Hh^Fp, Hh^Fp, Gs, Gs, Gs, Hh^Fp, Hh^Fp, Hh^Fp, Hh^Tf, Hh^Fp, Hh^Tf, Hh^Fp, Hh^Fms, Hh^Fms, Gg^Fms, Gg^Fms, Gg^Tf, Gg^Tf, Gg^Tf, Gg^Fp, Gg^Fmw, Gg^Fp
Wo, Ds, Hh^Fp, Hh^Fp, Hh^Fms, Hh^Fms, Hh^Fms, Gg^Fms, Ss, Ss, Ss, Hh^Fp, Gg^Fp, Gg^Fp, Hh^Fp, Gg^Fp, Hh^Fms, Hh^Fms, Gs, Hh^Fms, Gg^Fms, Hh^Fp, Gs, Hh^Tf, Hh^Tf, Hh^Tf, Hh^Fp, Hh^Fp, Gs, Hh^Fms, Gg^Fp, Gg^Fms, Mm^Xm, Mm, Mm, Gg^Fp, Gg^Fmw, Gg^Fp
Ds, Ds, Hh^Fp, Hh^Fp, Hh^Fms, Hh^Fms, Hh^Tf, Hh^Fms, Ss, Ss, Hh^Fp, Ss, Gg^Fp, Hh^Fp, Gs, Hh^Fms, Gs, Gs, Gs, Gs, Gg^Fp, Gg^Fms, Gs, Hh^Fp, Hh^Fp, Hh^Fp, Gs, Gs, Gs, Gg^Fms, Gg^Fp, Mm, Mm, Mm, Mm^Xm, Gg^Fms, Gg^Fms, Gg^Fp
Gg^Fp, Gg^Fp, Gg^Fms, Hh^Fms, Gg^Tf, Hh^Tf, Hh^Tf, Hh^Tf, Hh^Fms, Ss, Gg^Fms, Gg^Fms, Gs, Gs, Hh^Fms, Gs, Gg^Fp, Gs, Gs, Gg^Fp, Gg^Fp, Gg^Fp, Gg^Fp, Gs, Gg^Fp, Hh^Fp, Gs, Gs, Gs, Gg^Efm, Hh^Fp, Mm, Mm, Mm, Mm, Mm, Gg^Fms, Gg^Fms
Gg^Fp, Gg^Fms, Hh^Fp, Hh^Fms, Hh^Tf, Gg^Tf, Hh^Fp, Hh^Fp, Hh^Fp, Gg^Fms, Gs, Gs, Gs, Gs, Gg^Fms, Gg^Fms, Gg^Fms, Gg^Fp, Gs, Gs, Gs, Gg^Fp, Gg^Fp, Gs, Gs, Gs, Hh^Fp, Hh^Fms, Gg^Fms, Gg^Efm, Gg^Efm, Hh^Fp, Hh^Fms, Mm^Vu, Gg^Fp, Mm, Gg^Fp, Gg^Fms
Gg^Fp, Gg^Fp, Hh^Fp, Hh^Fp, Hh^Fp, Gg^Tf, Gg^Fms, Hh^Fp, Gg^Fp, Gs, Gg^Efm, Ss, Ss, Gg^Fp, Gg^Fp, Gg^Fp, Gg^Fdw, Gg^Fdw, Gs, Gs, Ss^Bw\r, Gs, Ss, Gg^Fdw, Hh^Fdw, Gs, Ss, Ss, Ss, Hh^Fms, Hh^Fms, Gs, Hh^Fms, Gg^Fp, Gg^Fp, Gg^Fp, Gg^Fmw, Gg^Fp
Gg, Gg^Fp, Hh^Fms, Hh^Fp, Hh^Fms, Gg^Fms, Mm^Vu, Mm^Xm, Mm, Gs, Gg^Efm, Gg^Fp, Gg^Fp, Ss, Ss, Gg^Fdw, Ss, Ss, Ai, Chs, Ss^Bw|r, Hh^Fdw, Ss, Ss, Ss, Ss, Ss, Gg^Fms, Gg^Fms, Ss, Hh, Gs, Hh^Tf, Gg^Fms, Gg^Fms, Gg^Fmw, Gg^Fms, Gg^Fms
Gg^Fms, Gg^Fms, Gg^Fp, Hh^Fms, Hh^Fp, Hh^Fp, Gg^Fms, Mm, Hh^Fms, Gs, Gs, Gg^Efm, Hh, Ss, Ss^Tf, Ss^Tf, Ss, Ss, Qxu, Ss, Rr^Pr|o, Ss, Ss, Hh^Fdw, Ss, Ss, Ss, Ss, Ss, Ss, Gg^Efm, Gg^Efm, Hh^Tf, Gg^Fms, Cte, Gg^Fms, Gg^Tf, Gg^Fp
Gg^Fp, Gg^Fms, Gll^Fp, Hh^Fp, Cte, Hh, Gg^Fms, Gg^Fp, Ss, Ss, Gs, Gs, Chs, Ss, Ss, Ss, Ai, Qxu, Qxu, Qxu, Qxu^Bcx|, Qxu, Qxu, Ai, Ai, Ss, Ss, Ss^Tf, Ss, Chs, Ss^Bw|r, Gg^Efm, Hh^Fms, Cte, Mm, Cte, Gg^Tf, Gg^Fms
Gg^Fp, Gll^Fms, Gll^Fms, 4 Kte, Mm, Gll^Tf, Gll^Tf, Gll^Fp, Ss, Gg^Efm, Gg^Efm, Gs, Ss, Ss, Ss^Tf, Ss, Ai, Qxu, Qxu, Qxu, Qxu^Bcx|, Qxu, Qxu, Qxu, Ss, Ss^Tf, Ss^Tf, Ss^Tf, Ss, Ss, Hh^Fms, Ss, Mm, Mm, Mm, 3 Kte, Gg^Fms, Gg^Tf
Gg^Fms, Gg^Fp, Gg^Fms, Cte, Mm, Mm, Mm, Mm^Vu, Hh^Tf, Hh^Fms, Gg^Efm, Hh^Fms, Ss, Ss, Ss^Tf, Ss^Tf, Ss, Qxu, Qxu, Qxu, Rr^Pr|o, Qxu, Qxu, Qxu, Ss, Ss, Ss, Ss, Ss, Ss, Gg^Efm, Mm^Vu, Hh^Fms, Mm, Mm^Xm, Mm, Gg^Fms, Gg^Fms
Gg^Fms, Gg^Fms, Gg^Fms, Cte, Mm, Mm, Mm, Mm, Ss^Tf, Ss, Ss^Bw|r, Ss, Hh^Fms, Ss, Ss, Ss, Ss, Ss, Ai, Ss, Ss^Bw|r, Ss, Ss^Tf, Ss^Tf, Ss^Tf, Ss, Ss, Ss, Gg^Fp, Hh^Fp, Gg^Efm, Gg^Efm, Gs, Mm, Mm, Mm, Gg^Fms, Gg^Fms
Gg^Fms, Gg, Gg^Fms, Mm, Mm, Mm, Hh^Tf, Ss^Tf, Ss, Hh^Fms, Gg^Efm, Gg^Efm, Gg^Efm, Hh^Fms, Hh, Gg^Fdw, Gg^Fdw, Ss, Ss, Ss, Ss^Bw\r, Chs, Gg^Efm, Gg^Efm, Gg^Efm, Gg^Efm, Ss, Gg^Fp, Ss, Hh^Fms, Gs, Gs, Gs, Mm, Mm, Mm, Gg^Fms, Gg^Fms
Gg^Fms, Gg^Fms, Mm, Mm^Xm, Mm, Mm^Vu, Hh^Fms, Hh^Fms, Hh^Tf, Hh^Fms, Gg^Fms, Gg^Efm, Gs, Gg^Efm, Hh^Fms, Ss, Ss, Ss, Ss, Ss, Ss, Gg^Efm, Gg^Efm, Gs, Gs, Gg^Efm, Hh^Fms, Ss, Gg^Fms, Gg^Fms, Gg^Fms, Gg^Fms, Gg^Efm, Mm^Vu, Hh^Fms, Hh^Fms, Gg^Fms, Gg^Fms
Gg^Tf, Hh^Fms, Hh^Tf, Mm, Mm, Hh^Fms, Hh^Fms, Hh^Tf, Gg^Tf, Gg^Fms, Gg^Fms, Gg^Fms, Gg^Fms, Gs, Hh^Fms, Ss, Ss, Ss, Hh^Fms, Ss, Gg^Fms, Hh^Fp, Gg^Efm, Hh^Fms, Hh^Fp, Hh^Fms, Gg^Fms, Ss, Hh^Fms, Hh^Fms, Hh^Fms, Gg^Fms, Ss, Gg^Efm, Gs, Gg, Gg^Fmw, Gg^Fms
Tb^Tf, Hh^Tf, Hh^Tf, Mm, Gg^Tf, Hh^Fms, Hh^Fms, Hh^Fms, Gg^Fp, Mm^Vu, Mm, Ss, Ss, Ss, Gg^Efm, Ss, Gg, Hh^Fms, Hh^Fms, Hh^Fms, Gg^Fms, Gg^Efm, Gg^Efm, Gg^Efm, Gs, Gg^Fms, Gg^Fmw, Hh^Fms, Ss, Ss, Ss, Ss, Ss, Ss, Gg, Gs, Gg^Fmw, Gg^Fms
Gg^Fms, Hh^Tf, Hh^Fms, Mm, Mm, Hh^Tf, Hh^Tf, Mm, Mm, Mm, Mm, Ss, Hh^Fms, Gg^Efm, Gs, Gs, Hh^Fms, Hh^Fms, Hh^Fdw, Hh^Fdw, Gg^Fms, Hh^Fms, Hh^Fms, Gs, Gg^Fms, Gg^Fms, Gg^Fmw, Hh^Fms, Ss, Ss, Hh^Fds, Hh^Fms, Gg^Efm, Hh^Fds, Gs, Gg^Fms, Gg^Fmw, Gg^Fms
Gg^Fms, Gg^Fms, Gg^Fms, Gg^Fms, Gs^Fds, Gg^Tf, Gs^Tf, Gg^Fms, Mm, Mm, Hh^Fms, Ss, Hh^Fms, Gg^Fms, Gs, Gs, Gs, Hh^Fms, Hh^Fdw, Hh^Fdw, Gg^Fdw, Hh^Fms, Hh^Fms, Gs, Gs, Gg^Fms, Gg^Fds, Hh^Fds, Hh^Fds, Hh^Fds, Hh^Fds, Hh^Fms, Gg^Efm, Gg^Efm, Gs^Vct, Gg^Fds, Gg^Fms, Gg^Fmw
Gg^Fms, Gg^Fms, Gg^Fms, Gs^Fds, Gg^Fms, Gs^Fds, Gg^Fp, Gs^Fp, Gll^Fp, Gs^Fds, Hh^Fds, Hh^Fms, Gg^Fms, Gg^Efm, Gs, Gg^Fds, Gg^Fp, Hh^Fp, Gg^Fms, Gg^Fp, Gg^Fms, Gg^Fms, Gg^Efm, Gg^Efm, Gg^Efm, Gg^Efm, Gg^Fms, Gg^Fp, Gg^Fp, Gg^Fms, Gg^Fms, Gg^Vct, Gg^Efm, Gg^Efm, Gg^Fms, Gg^Fds, Gg^Fds, Gg^Fms
Gg^Fms, Gg^Fms, Gg^Fms, Gg^Fms, Gg^Tf, Gg^Fp, Gg^Fms, Gg^Fp, Gs^Fdw, Gg^Fms, Gg^Fdw, Gg^Fms, Gs^Fms, Gg^Efm, Gs^Fp, Gs^Fp, Gs^Fds, Gs^Fds, Gs, Gs^Fds, Gs, Gs^Fds, Gg^Efm, Gs, Gs, Gg^Fms, Gs, Gs, Gs^Vct, Gs, Gg^Fms, Gg^Fms, Gs, Gg^Fms, Gs, Gg^Vct, Gg^Fms, Gg^Fms
Gg^Fms, Gg^Fms, Gs^Fds, Gs^Fds, Gs^Fds, Gs^Tf, Gs^Fp, Gs^Fds, Gs^Tf, Gs^Fdw, Gs^Fds, Gs^Fdw, Gs^Fp, Gs^Fp, Gs^Fp, Gg^Fp, Gs^Fms, Gg^Fds, Gg^Fms, Gs, Gg^Fms, Gg^Fds, Gg^Fms, Gg^Fds, Gg^Fms, Gs, Gg^Fms, Gg^Fms, Gg^Fms, Gs, Gs, Gs, Ce, Gs, 1 Ke, Ce, Ce, Gg^Fms
Gg^Fms, Gs^Fds, Gg^Fms, Gs^Fds, Gg^Fms, Gg^Fms, Gg^Fms, Gs^Tf, Gs^Fds, Gs^Tf, Gs^Fds, Gs^Fdw, Gg^Fms, Gs^Fds, Gg^Fms, Gs^Fds, Gg^Fms, Gg^Fms, Gg^Fms, Gg^Fds, Gg^Fms, Gg^Fms, Gg^Fdw, Gg^Fdw, Gg^Fdw, Gg^Fms, Gg^Fms, Gg^Fms, Gg^Fms, Gg^Fms, Gg^Fms, Gs, Gs, Ce, Ce, Ce, Gg, Gg
Wo, Gg^Fms, Gg^Fms, Gg^Fms, Gg^Fms, Gg^Fms, Gg^Fms, Gg^Fms, Gg^Fms, Gg^Fms, Gg^Fms, Gg^Fms, Gg^Fms, Gg^Fms, Gg^Fms, Gg^Fms, Gg^Fms, Gg^Fms, Gg^Fds, Gg^Fds, Gg^Fds, Gg^Fdw, Gg^Fms, Gg^Fms, Gg^Fms, Gg^Fms, Gg^Fms, Gg^Fms, Gg^Fms, Gg^Fms, Gg^Fms, Gg^Fms, Gg^Fms, Ce, Gg, Gg, Gll^Fp, Gll^Fp
